Estado,Sembrada_ha,Cosechada_ha,Año,Mes,Tipo_sequia,perdida_ha,producto
Chiapas,95263,2676,2004,1,NPS,92587,maiz
Quintana Roo,4040,500,2004,1,NPS,3540,maiz
Chiapas,99607,5594,2004,2,NPS,94013,maiz
Guerrero,811,12,2004,2,NPS,799,maiz
Nayarit,2494,40,2004,2,NPS,2454,maiz
Oaxaca,54644,368,2004,2,NPS,54276,maiz
Quintana Roo,5988,4000,2004,2,NPS,1988,maiz
San Luis Potosí,13173,4057,2004,2,NPS,9116,maiz
Sinaloa,7663,1973,2004,2,NPS,5690,maiz
Veracruz de Ignacio de la Llave,176739,266,2004,2,NPS,176473,maiz
Campeche,4728,1717,2004,3,NPS,3011,maiz
Chiapas,99900,24716,2004,3,NPS,75184,maiz
Guerrero,811,455,2004,3,NPS,356,maiz
Jalisco,1219,140,2004,3,NPS,1079,maiz
Nayarit,2537,950,2004,3,NPS,1587,maiz
Oaxaca,54644,13828,2004,3,NPS,40816,maiz
Quintana Roo,5988,4385,2004,3,NPS,1603,maiz
San Luis Potosí,13449,6630,2004,3,NPS,6819,maiz
Sinaloa,7814,3247,2004,3,NPS,4567,maiz
Tabasco,42411,2965,2004,3,NPS,39446,maiz
Tamaulipas,21882,1600,2004,3,NPS,20282,maiz
Veracruz de Ignacio de la Llave,194122,5514,2004,3,NPS,188608,maiz
Campeche,4728,2873,2004,4,NPS,1855,maiz
Chiapas,99910,51328,2004,4,NPS,48582,maiz
Guerrero,811,781,2004,4,NPS,30,maiz
Hidalgo,23566,7239,2004,4,NPS,16327,maiz
Jalisco,1247,869,2004,4,NPS,378,maiz
Nayarit,2537,2341,2004,4,NPS,196,maiz
Oaxaca,54644,36633,2004,4,NPS,18011,maiz
Quintana Roo,5988,4385,2004,4,NPS,1603,maiz
San Luis Potosí,12804,8483,2004,4,NPS,4321,maiz
Sinaloa,7814,7176,2004,4,NPS,638,maiz
Tabasco,42411,11860,2004,4,NPS,30551,maiz
Tamaulipas,22515,2829,2004,4,NPS,19686,maiz
Veracruz de Ignacio de la Llave,194638,49692,2004,4,NPS,144946,maiz
Yucatán,1050,1050,2004,4,NPS,0,maiz
Baja California,2,2,2004,5,D1,0,maiz
Campeche,4728,2873,2004,5,NPS,1855,maiz
Chiapas,99910,60301,2004,5,NPS,39609,maiz
Guerrero,811,803,2004,5,NPS,8,maiz
Hidalgo,23566,22138,2004,5,NPS,1428,maiz
Jalisco,1247,979,2004,5,NPS,268,maiz
Nayarit,2565,2371,2004,5,D0,194,maiz
Oaxaca,54644,49230,2004,5,NPS,5414,maiz
Quintana Roo,5988,4385,2004,5,NPS,1603,maiz
San Luis Potosí,12804,11728,2004,5,NPS,1076,maiz
Sinaloa,7814,7327,2004,5,NPS,487,maiz
Tabasco,42411,33066,2004,5,NPS,9345,maiz
Tamaulipas,22950,5574,2004,5,NPS,17376,maiz
Veracruz de Ignacio de la Llave,198154,106415,2004,5,NPS,91739,maiz
Yucatán,1050,1050,2004,5,NPS,0,maiz
Baja California,2,2,2004,6,D1,0,maiz
Campeche,4728,2873,2004,6,D0,1855,maiz
Chiapas,99910,85541,2004,6,NPS,14369,maiz
Guerrero,811,811,2004,6,NPS,0,maiz
Hidalgo,23566,23566,2004,6,NPS,0,maiz
Jalisco,1247,1207,2004,6,NPS,40,maiz
Michoacán de Ocampo,118,8,2004,6,NPS,110,maiz
Nayarit,2550,2509,2004,6,D0,41,maiz
Nuevo León,4920,241,2004,6,NPS,4679,maiz
Oaxaca,53854,53709,2004,6,NPS,145,maiz
Puebla,23127,5608,2004,6,NPS,17519,maiz
Quintana Roo,5988,4385,2004,6,NPS,1603,maiz
San Luis Potosí,12804,12453,2004,6,NPS,351,maiz
Sinaloa,7814,7327,2004,6,NPS,487,maiz
Tabasco,42411,38177,2004,6,D0,4234,maiz
Tamaulipas,22950,5779,2004,6,NPS,17171,maiz
Veracruz de Ignacio de la Llave,198154,147973,2004,6,NPS,50181,maiz
Yucatán,1050,1050,2004,6,D0,0,maiz
Baja California,2,2,2004,7,D1,0,maiz
Campeche,4728,4513,2004,7,NPS,215,maiz
Chiapas,99910,95256,2004,7,NPS,4654,maiz
Guerrero,811,811,2004,7,NPS,0,maiz
Hidalgo,23566,23566,2004,7,NPS,0,maiz
Jalisco,1247,1207,2004,7,NPS,40,maiz
Michoacán de Ocampo,118,8,2004,7,NPS,110,maiz
Nayarit,2550,2544,2004,7,NPS,6,maiz
Nuevo León,4920,981,2004,7,NPS,3939,maiz
Oaxaca,53854,53709,2004,7,NPS,145,maiz
Puebla,23127,5717,2004,7,NPS,17410,maiz
Quintana Roo,5988,4385,2004,7,D0,1603,maiz
San Luis Potosí,12804,12453,2004,7,NPS,351,maiz
Sinaloa,7814,7527,2004,7,NPS,287,maiz
Tabasco,42411,40167,2004,7,D0,2244,maiz
Tamaulipas,22950,19761,2004,7,NPS,3189,maiz
Veracruz de Ignacio de la Llave,198159,186559,2004,7,NPS,11600,maiz
Yucatán,1050,1050,2004,7,NPS,0,maiz
Baja California,2,2,2004,8,D1,0,maiz
Campeche,4728,4513,2004,8,D0,215,maiz
Chiapas,99910,98515,2004,8,D0,1395,maiz
Guerrero,811,811,2004,8,NPS,0,maiz
Hidalgo,23566,23566,2004,8,NPS,0,maiz
Jalisco,1247,1247,2004,8,NPS,0,maiz
Michoacán de Ocampo,118,8,2004,8,NPS,110,maiz
Nayarit,2550,2544,2004,8,D0,6,maiz
Nuevo León,4920,1318,2004,8,NPS,3602,maiz
Oaxaca,53854,53709,2004,8,NPS,145,maiz
Puebla,23127,19829,2004,8,NPS,3298,maiz
Quintana Roo,5988,4385,2004,8,D0,1603,maiz
San Luis Potosí,12804,12453,2004,8,NPS,351,maiz
Sinaloa,7814,7527,2004,8,NPS,287,maiz
Tabasco,42411,40282,2004,8,D0,2129,maiz
Tamaulipas,22950,22824,2004,8,NPS,126,maiz
Veracruz de Ignacio de la Llave,198159,189799,2004,8,D0,8360,maiz
Yucatán,1050,1050,2004,8,NPS,0,maiz
Baja California,2,2,2004,9,D2,0,maiz
Campeche,4728,4513,2004,9,D0,215,maiz
Chiapas,99910,99456,2004,9,D1,454,maiz
Guerrero,811,811,2004,9,NPS,0,maiz
Hidalgo,23566,23566,2004,9,NPS,0,maiz
Jalisco,1247,1247,2004,9,NPS,0,maiz
Michoacán de Ocampo,118,118,2004,9,NPS,0,maiz
Nayarit,2550,2544,2004,9,D0,6,maiz
Nuevo León,4920,4772,2004,9,NPS,148,maiz
Oaxaca,53854,53709,2004,9,D1,145,maiz
Puebla,23127,20419,2004,9,NPS,2708,maiz
Quintana Roo,5988,4385,2004,9,D1,1603,maiz
San Luis Potosí,12804,12453,2004,9,NPS,351,maiz
Sinaloa,7814,7527,2004,9,NPS,287,maiz
Tabasco,42411,40282,2004,9,D1,2129,maiz
Tamaulipas,22950,22903,2004,9,NPS,47,maiz
Veracruz de Ignacio de la Llave,198159,192063,2004,9,D0,6096,maiz
Yucatán,1050,1050,2004,9,D0,0,maiz
Baja California,2,2,2004,12,NPS,0,maiz
Campeche,4728,4513,2004,12,D0,215,maiz
Chiapas,99910,99456,2004,12,D1,454,maiz
Guerrero,811,811,2004,12,NPS,0,maiz
Hidalgo,23566,23566,2004,12,NPS,0,maiz
Jalisco,1247,1247,2004,12,NPS,0,maiz
Michoacán de Ocampo,118,118,2004,12,NPS,0,maiz
Nayarit,2550,2544,2004,12,NPS,6,maiz
Nuevo León,4920,4772,2004,12,NPS,148,maiz
Oaxaca,53854,53709,2004,12,D0,145,maiz
Puebla,23127,20419,2004,12,NPS,2708,maiz
Quintana Roo,5988,4385,2004,12,D1,1603,maiz
San Luis Potosí,12804,12453,2004,12,NPS,351,maiz
Sinaloa,7814,7527,2004,12,NPS,287,maiz
Tabasco,42411,40282,2004,12,D1,2129,maiz
Tamaulipas,22950,22903,2004,12,NPS,47,maiz
Veracruz de Ignacio de la Llave,198159,192063,2004,12,D0,6096,maiz
Yucatán,1050,1050,2004,12,NPS,0,maiz
Oaxaca,49907,850,2005,1,D0,49057,maiz
Quintana Roo,5021,810,2005,1,D1,4211,maiz
Campeche,5854,1146,2005,2,D1,4708,maiz
Chiapas,91352,30,2005,2,D1,91322,maiz
Nayarit,3400,674,2005,2,NPS,2726,maiz
Oaxaca,52686,2039,2005,2,D0,50647,maiz
Quintana Roo,5021,1220,2005,2,D1,3801,maiz
Sinaloa,4536,1755,2005,2,NPS,2781,maiz
Veracruz de Ignacio de la Llave,170016,1458,2005,2,D1,168558,maiz
Campeche,5854,1775,2005,3,D1,4079,maiz
Chiapas,91352,8618,2005,3,D1,82734,maiz
Guerrero,1483,60,2005,3,NPS,1423,maiz
Jalisco,1213,297,2005,3,NPS,916,maiz
Nayarit,3400,1474,2005,3,NPS,1926,maiz
Oaxaca,52895,19568,2005,3,NPS,33327,maiz
Quintana Roo,5021,1311,2005,3,D1,3710,maiz
San Luis Potosí,11799,599,2005,3,NPS,11200,maiz
Sinaloa,4560,2455,2005,3,NPS,2105,maiz
Tamaulipas,9254,1360,2005,3,NPS,7894,maiz
Veracruz de Ignacio de la Llave,173870,28066,2005,3,D1,145804,maiz
Campeche,5854,3463,2005,4,D1,2391,maiz
Chiapas,96434,24251,2005,4,D1,72183,maiz
Guerrero,1483,1315,2005,4,NPS,168,maiz
Hidalgo,22569,6200,2005,4,NPS,16369,maiz
Jalisco,1213,812,2005,4,NPS,401,maiz
Nayarit,3400,1926,2005,4,NPS,1474,maiz
Oaxaca,52895,41343,2005,4,D0,11552,maiz
Quintana Roo,5021,1311,2005,4,D1,3710,maiz
San Luis Potosí,11799,2515,2005,4,NPS,9284,maiz
Sinaloa,4560,4000,2005,4,NPS,560,maiz
Tabasco,39517,11700,2005,4,D2,27817,maiz
Tamaulipas,10748,3980,2005,4,NPS,6768,maiz
Veracruz de Ignacio de la Llave,182644,58827,2005,4,D1,123817,maiz
Yucatán,1070,1050,2005,4,D0,20,maiz
Baja California,8,3,2005,5,NPS,5,maiz
Campeche,5854,4013,2005,5,D0,1841,maiz
Chiapas,96434,57355,2005,5,D1,39079,maiz
Chihuahua,20,7,2005,5,NPS,13,maiz
Guerrero,1483,1425,2005,5,NPS,58,maiz
Hidalgo,22569,14248,2005,5,NPS,8321,maiz
Jalisco,1213,1111,2005,5,D0,102,maiz
Nayarit,3400,2872,2005,5,NPS,528,maiz
Nuevo León,3662,1835,2005,5,NPS,1827,maiz
Oaxaca,52896,44010,2005,5,NPS,8886,maiz
Puebla,34179,1045,2005,5,NPS,33134,maiz
Quintana Roo,5021,4311,2005,5,D1,710,maiz
San Luis Potosí,11799,7452,2005,5,NPS,4347,maiz
Sinaloa,4560,4344,2005,5,NPS,216,maiz
Tabasco,39517,27296,2005,5,D2,12221,maiz
Tamaulipas,11221,4125,2005,5,NPS,7096,maiz
Veracruz de Ignacio de la Llave,182644,99907,2005,5,D1,82737,maiz
Yucatán,1070,1050,2005,5,D0,20,maiz
Baja California,8,3,2005,6,NPS,5,maiz
Campeche,5854,4013,2005,6,NPS,1841,maiz
Chiapas,96434,77051,2005,6,NPS,19383,maiz
Chihuahua,20,7,2005,6,NPS,13,maiz
Guerrero,1483,1433,2005,6,D0,50,maiz
Hidalgo,22569,20155,2005,6,NPS,2414,maiz
Jalisco,1213,1153,2005,6,D0,60,maiz
Nayarit,3400,3311,2005,6,NPS,89,maiz
Nuevo León,3662,1685,2005,6,NPS,1977,maiz
Oaxaca,52896,52727,2005,6,NPS,169,maiz
Puebla,34176,3592,2005,6,NPS,30584,maiz
Quintana Roo,5021,4811,2005,6,D0,210,maiz
San Luis Potosí,11799,9645,2005,6,NPS,2154,maiz
Sinaloa,4560,4466,2005,6,NPS,94,maiz
Tabasco,39517,28016,2005,6,D1,11501,maiz
Tamaulipas,11221,4245,2005,6,NPS,6976,maiz
Veracruz de Ignacio de la Llave,182644,135074,2005,6,D0,47570,maiz
Yucatán,1070,1060,2005,6,NPS,10,maiz
Baja California,8,3,2005,7,NPS,5,maiz
Campeche,5854,4013,2005,7,NPS,1841,maiz
Chiapas,96434,80706,2005,7,NPS,15728,maiz
Chihuahua,20,7,2005,7,NPS,13,maiz
Guerrero,1483,1483,2005,7,NPS,0,maiz
Hidalgo,22569,22569,2005,7,D0,0,maiz
Jalisco,1213,1153,2005,7,NPS,60,maiz
Nayarit,3400,3311,2005,7,D0,89,maiz
Nuevo León,3662,3324,2005,7,NPS,338,maiz
Oaxaca,52896,52862,2005,7,NPS,34,maiz
Puebla,34176,11298,2005,7,NPS,22878,maiz
Quintana Roo,5021,4811,2005,7,NPS,210,maiz
San Luis Potosí,11799,9645,2005,7,NPS,2154,maiz
Sinaloa,4560,4466,2005,7,NPS,94,maiz
Tabasco,39517,28016,2005,7,D0,11501,maiz
Tamaulipas,11221,5148,2005,7,NPS,6073,maiz
Veracruz de Ignacio de la Llave,182734,151849,2005,7,NPS,30885,maiz
Yucatán,1070,1070,2005,7,NPS,0,maiz
Baja California,5,3,2005,8,NPS,2,maiz
Campeche,5854,4013,2005,8,NPS,1841,maiz
Chiapas,96434,85914,2005,8,NPS,10520,maiz
Chihuahua,20,7,2005,8,NPS,13,maiz
Guerrero,1483,1483,2005,8,NPS,0,maiz
Hidalgo,22569,22569,2005,8,NPS,0,maiz
Jalisco,1213,1213,2005,8,NPS,0,maiz
Nayarit,3400,3311,2005,8,NPS,89,maiz
Nuevo León,3662,3332,2005,8,D0,330,maiz
Oaxaca,52896,52862,2005,8,NPS,34,maiz
Puebla,34176,11928,2005,8,NPS,22248,maiz
Quintana Roo,5021,4811,2005,8,D0,210,maiz
San Luis Potosí,11799,9645,2005,8,NPS,2154,maiz
Sinaloa,4560,4466,2005,8,NPS,94,maiz
Sonora,5,5,2005,8,NPS,0,maiz
Tabasco,39517,28016,2005,8,NPS,11501,maiz
Tamaulipas,11221,5692,2005,8,NPS,5529,maiz
Veracruz de Ignacio de la Llave,182734,157587,2005,8,NPS,25147,maiz
Yucatán,1070,1070,2005,8,NPS,0,maiz
Baja California,5,5,2005,9,NPS,0,maiz
Campeche,5854,4013,2005,9,NPS,1841,maiz
Chiapas,96434,92340,2005,9,NPS,4094,maiz
Chihuahua,20,7,2005,9,NPS,13,maiz
Guerrero,1483,1483,2005,9,NPS,0,maiz
Hidalgo,22569,22569,2005,9,NPS,0,maiz
Jalisco,1213,1213,2005,9,D0,0,maiz
Nayarit,3400,3311,2005,9,D0,89,maiz
Nuevo León,3662,3332,2005,9,D0,330,maiz
Oaxaca,52896,52862,2005,9,NPS,34,maiz
Puebla,34176,12028,2005,9,D0,22148,maiz
Quintana Roo,5021,4811,2005,9,NPS,210,maiz
San Luis Potosí,11799,9645,2005,9,NPS,2154,maiz
Sinaloa,4560,4466,2005,9,D0,94,maiz
Sonora,5,5,2005,9,NPS,0,maiz
Tabasco,39517,28016,2005,9,NPS,11501,maiz
Tamaulipas,11221,5852,2005,9,D0,5369,maiz
Veracruz de Ignacio de la Llave,182834,160332,2005,9,NPS,22502,maiz
Yucatán,1070,1070,2005,9,NPS,0,maiz
Baja California,5,5,2005,12,NPS,0,maiz
Campeche,5854,4013,2005,12,D0,1841,maiz
Chiapas,96434,92340,2005,12,NPS,4094,maiz
Chihuahua,20,7,2005,12,D0,13,maiz
Guerrero,1483,1483,2005,12,D0,0,maiz
Hidalgo,22569,22569,2005,12,D0,0,maiz
Jalisco,1213,1213,2005,12,D1,0,maiz
Nayarit,3400,3311,2005,12,D0,89,maiz
Nuevo León,3662,3332,2005,12,NPS,330,maiz
Oaxaca,52896,52862,2005,12,NPS,34,maiz
Puebla,34176,12028,2005,12,D0,22148,maiz
Quintana Roo,5021,4811,2005,12,NPS,210,maiz
San Luis Potosí,11799,9645,2005,12,D0,2154,maiz
Sinaloa,4560,4466,2005,12,D1,94,maiz
Sonora,5,5,2005,12,D0,0,maiz
Tabasco,39517,28016,2005,12,NPS,11501,maiz
Tamaulipas,11221,5852,2005,12,D0,5369,maiz
Veracruz de Ignacio de la Llave,182834,160332,2005,12,NPS,22502,maiz
Yucatán,1070,1070,2005,12,NPS,0,maiz
Oaxaca,40148,501,2006,1,D0,39647,maiz
Sinaloa,4403,1500,2006,1,D1,2903,maiz
Veracruz de Ignacio de la Llave,154604,20,2006,1,NPS,154584,maiz
Campeche,3160,220,2006,2,NPS,2940,maiz
Chiapas,96402,5260,2006,2,NPS,91142,maiz
Nayarit,2195,245,2006,2,D1,1950,maiz
Oaxaca,45690,20627,2006,2,D0,25063,maiz
Quintana Roo,4533,3189,2006,2,NPS,1344,maiz
Sinaloa,4442,368,2006,2,D3,4074,maiz
Veracruz de Ignacio de la Llave,180805,1340,2006,2,NPS,179465,maiz
Campeche,3160,220,2006,3,NPS,2940,maiz
Chiapas,96682,15958,2006,3,NPS,80724,maiz
Hidalgo,21875,1564,2006,3,D1,20311,maiz
Jalisco,1264,200,2006,3,D2,1064,maiz
Nayarit,2244,290,2006,3,D2,1954,maiz
Oaxaca,45866,23916,2006,3,NPS,21950,maiz
Quintana Roo,4533,3432,2006,3,NPS,1101,maiz
San Luis Potosí,11271,1128,2006,3,D0,10143,maiz
Sinaloa,4442,368,2006,3,D4,4074,maiz
Tabasco,35007,390,2006,3,NPS,34617,maiz
Veracruz de Ignacio de la Llave,181711,21654,2006,3,NPS,160057,maiz
Campeche,4950,4575,2006,4,NPS,375,maiz
Chiapas,96682,41082,2006,4,NPS,55600,maiz
Guerrero,1445,1427,2006,4,D1,18,maiz
Hidalgo,21875,11962,2006,4,D1,9913,maiz
Jalisco,1234,450,2006,4,D2,784,maiz
Nayarit,2244,916,2006,4,D2,1328,maiz
Oaxaca,45866,25802,2006,4,NPS,20064,maiz
Quintana Roo,4533,3432,2006,4,D0,1101,maiz
San Luis Potosí,11271,6320,2006,4,D0,4951,maiz
Sinaloa,4442,368,2006,4,D4,4074,maiz
Tabasco,39687,19910,2006,4,NPS,19777,maiz
Tamaulipas,7954,2629,2006,4,D0,5325,maiz
Veracruz de Ignacio de la Llave,183452,53954,2006,4,NPS,129498,maiz
Yucatán,768,753,2006,4,D0,15,maiz
Campeche,4950,4905,2006,5,NPS,45,maiz
Chiapas,96682,68552,2006,5,NPS,28130,maiz
Guerrero,1445,1445,2006,5,NPS,0,maiz
Hidalgo,21875,19970,2006,5,D0,1905,maiz
Jalisco,1234,1025,2006,5,D2,209,maiz
Nayarit,2256,1720,2006,5,D2,536,maiz
Oaxaca,45866,32500,2006,5,NPS,13366,maiz
Puebla,45117,1045,2006,5,D0,44072,maiz
Quintana Roo,4533,3432,2006,5,NPS,1101,maiz
San Luis Potosí,11271,10508,2006,5,NPS,763,maiz
Sinaloa,4442,3256,2006,5,D4,1186,maiz
Tabasco,39687,35296,2006,5,NPS,4391,maiz
Tamaulipas,7954,5289,2006,5,NPS,2665,maiz
Veracruz de Ignacio de la Llave,183452,101016,2006,5,NPS,82436,maiz
Yucatán,768,753,2006,5,NPS,15,maiz
Campeche,4950,4905,2006,6,NPS,45,maiz
Chiapas,96682,90046,2006,6,NPS,6636,maiz
Guerrero,1445,1445,2006,6,NPS,0,maiz
Hidalgo,21875,21465,2006,6,D0,410,maiz
Jalisco,1234,1025,2006,6,D2,209,maiz
Nayarit,2256,2252,2006,6,D3,4,maiz
Nuevo León,2047,40,2006,6,D1,2007,maiz
Oaxaca,45866,44864,2006,6,NPS,1002,maiz
Puebla,45117,5382,2006,6,D0,39735,maiz
Querétaro de Arteaga,20,20,2006,6,D1,0,maiz
Quintana Roo,4533,4533,2006,6,D0,0,maiz
San Luis Potosí,11271,10508,2006,6,D0,763,maiz
Sinaloa,4342,3386,2006,6,D4,956,maiz
Tabasco,39687,38077,2006,6,NPS,1610,maiz
Tamaulipas,7954,5620,2006,6,D0,2334,maiz
Veracruz de Ignacio de la Llave,184929,147173,2006,6,NPS,37756,maiz
Yucatán,768,753,2006,6,NPS,15,maiz
Campeche,4950,4905,2006,7,NPS,45,maiz
Chiapas,96682,93406,2006,7,NPS,3276,maiz
Guerrero,1445,1445,2006,7,NPS,0,maiz
Hidalgo,21875,21875,2006,7,D0,0,maiz
Jalisco,1234,1037,2006,7,D1,197,maiz
Nayarit,2256,2252,2006,7,D2,4,maiz
Nuevo León,2047,1410,2006,7,D1,637,maiz
Oaxaca,45866,45149,2006,7,NPS,717,maiz
Puebla,45117,12827,2006,7,D0,32290,maiz
Querétaro de Arteaga,20,20,2006,7,D0,0,maiz
Quintana Roo,4533,4533,2006,7,NPS,0,maiz
San Luis Potosí,11271,10508,2006,7,D0,763,maiz
Sinaloa,4342,3464,2006,7,D3,878,maiz
Tabasco,39687,38427,2006,7,NPS,1260,maiz
Tamaulipas,7954,6207,2006,7,D0,1747,maiz
Veracruz de Ignacio de la Llave,184929,174683,2006,7,NPS,10246,maiz
Yucatán,768,753,2006,7,D0,15,maiz
Campeche,4950,4905,2006,8,NPS,45,maiz
Chiapas,96682,95306,2006,8,NPS,1376,maiz
Guerrero,1445,1445,2006,8,NPS,0,maiz
Hidalgo,21875,21875,2006,8,NPS,0,maiz
Jalisco,1234,1234,2006,8,D0,0,maiz
Nayarit,2256,2252,2006,8,D1,4,maiz
Nuevo León,2047,1422,2006,8,D3,625,maiz
Oaxaca,45866,45149,2006,8,NPS,717,maiz
Puebla,45117,23472,2006,8,D0,21645,maiz
Querétaro de Arteaga,20,20,2006,8,NPS,0,maiz
Quintana Roo,4533,4533,2006,8,NPS,0,maiz
San Luis Potosí,11271,10508,2006,8,NPS,763,maiz
Sinaloa,4342,3464,2006,8,D1,878,maiz
Tabasco,39687,38427,2006,8,NPS,1260,maiz
Tamaulipas,7954,6292,2006,8,D0,1662,maiz
Veracruz de Ignacio de la Llave,184929,177463,2006,8,D1,7466,maiz
Yucatán,768,753,2006,8,NPS,15,maiz
Campeche,4950,4905,2006,9,D0,45,maiz
Chiapas,96682,95306,2006,9,D0,1376,maiz
Guerrero,1445,1445,2006,9,NPS,0,maiz
Hidalgo,21875,21875,2006,9,NPS,0,maiz
Jalisco,1234,1234,2006,9,D0,0,maiz
Nayarit,2256,2252,2006,9,D1,4,maiz
Nuevo León,2047,1422,2006,9,NPS,625,maiz
Oaxaca,45866,45149,2006,9,NPS,717,maiz
Puebla,33977,27707,2006,9,NPS,6270,maiz
Querétaro de Arteaga,20,20,2006,9,NPS,0,maiz
Quintana Roo,4533,4533,2006,9,NPS,0,maiz
San Luis Potosí,11271,10508,2006,9,NPS,763,maiz
Sinaloa,4342,3464,2006,9,NPS,878,maiz
Sonora,4,4,2006,9,NPS,0,maiz
Tabasco,39687,38427,2006,9,D0,1260,maiz
Tamaulipas,7954,6292,2006,9,D0,1662,maiz
Veracruz de Ignacio de la Llave,184929,177463,2006,9,NPS,7466,maiz
Yucatán,768,753,2006,9,D0,15,maiz
Campeche,4950,4905,2006,12,NPS,45,maiz
Chiapas,96682,95306,2006,12,NPS,1376,maiz
Guerrero,1445,1445,2006,12,NPS,0,maiz
Hidalgo,21875,21875,2006,12,NPS,0,maiz
Jalisco,1234,1234,2006,12,NPS,0,maiz
Nayarit,2256,2252,2006,12,D0,4,maiz
Nuevo León,2047,1422,2006,12,NPS,625,maiz
Oaxaca,45866,45149,2006,12,NPS,717,maiz
Puebla,33977,27707,2006,12,NPS,6270,maiz
Querétaro de Arteaga,20,20,2006,12,NPS,0,maiz
Quintana Roo,4533,4533,2006,12,NPS,0,maiz
San Luis Potosí,11271,10508,2006,12,NPS,763,maiz
Sinaloa,4342,3464,2006,12,NPS,878,maiz
Sonora,4,4,2006,12,D0,0,maiz
Tabasco,39687,38427,2006,12,NPS,1260,maiz
Tamaulipas,7954,6292,2006,12,NPS,1662,maiz
Veracruz de Ignacio de la Llave,184929,177463,2006,12,NPS,7466,maiz
Yucatán,768,753,2006,12,NPS,15,maiz
Quintana Roo,3321,1634,2007,1,D0,1687,maiz
Chiapas,100898,1624,2007,2,NPS,99274,maiz
Nayarit,2251,55,2007,2,D1,2196,maiz
Oaxaca,56082,26150,2007,2,NPS,29932,maiz
Quintana Roo,3332,3064,2007,2,D1,268,maiz
Sinaloa,4569,1437,2007,2,D0,3132,maiz
Tamaulipas,6605,570,2007,2,NPS,6035,maiz
Veracruz de Ignacio de la Llave,173612,371,2007,2,NPS,173241,maiz
Campeche,2922,910,2007,3,NPS,2012,maiz
Chiapas,100898,18568,2007,3,D0,82330,maiz
Guerrero,1542,596,2007,3,D1,946,maiz
Nayarit,2251,55,2007,3,D1,2196,maiz
Oaxaca,56082,30289,2007,3,NPS,25793,maiz
Quintana Roo,3332,3068,2007,3,NPS,264,maiz
Sinaloa,4628,1437,2007,3,D1,3191,maiz
Tabasco,37972,8348,2007,3,NPS,29624,maiz
Tamaulipas,6915,3200,2007,3,NPS,3715,maiz
Veracruz de Ignacio de la Llave,176053,18096,2007,3,NPS,157957,maiz
Yucatán,540,300,2007,3,NPS,240,maiz
Campeche,3062,1860,2007,4,D0,1202,maiz
Chiapas,100898,32472,2007,4,D2,68426,maiz
Guerrero,1542,1453,2007,4,NPS,89,maiz
Hidalgo,22505,13694,2007,4,NPS,8811,maiz
Jalisco,1168,588,2007,4,D2,580,maiz
Nayarit,2251,694,2007,4,D2,1557,maiz
Oaxaca,46518,39575,2007,4,D0,6943,maiz
Quintana Roo,3332,3068,2007,4,D2,264,maiz
Sinaloa,11328,8442,2007,4,D3,2886,maiz
Tabasco,39152,19810,2007,4,D0,19342,maiz
Tamaulipas,7115,5699,2007,4,NPS,1416,maiz
Veracruz de Ignacio de la Llave,170505,44471,2007,4,NPS,126034,maiz
Yucatán,540,520,2007,4,D1,20,maiz
Campeche,4662,4277,2007,5,D0,385,maiz
Chiapas,100730,72512,2007,5,D1,28218,maiz
Chihuahua,25,11,2007,5,NPS,14,maiz
Guerrero,1542,1542,2007,5,NPS,0,maiz
Hidalgo,22505,22243,2007,5,NPS,262,maiz
Jalisco,1168,1134,2007,5,D1,34,maiz
Michoacán de Ocampo,625,130,2007,5,NPS,495,maiz
Nayarit,2251,1936,2007,5,D1,315,maiz
Oaxaca,49253,47249,2007,5,NPS,2004,maiz
Puebla,24591,1100,2007,5,NPS,23491,maiz
Querétaro de Arteaga,15,15,2007,5,NPS,0,maiz
Quintana Roo,3332,3068,2007,5,D2,264,maiz
San Luis Potosí,10562,6107,2007,5,NPS,4455,maiz
Sinaloa,11328,9743,2007,5,D1,1585,maiz
Tabasco,39152,30225,2007,5,D1,8927,maiz
Tamaulipas,7315,6300,2007,5,NPS,1015,maiz
Veracruz de Ignacio de la Llave,170905,106502,2007,5,NPS,64403,maiz
Yucatán,540,529,2007,5,D2,11,maiz
Campeche,5062,4977,2007,6,D1,85,maiz
Chiapas,100730,96354,2007,6,D1,4376,maiz
Chihuahua,25,19,2007,6,NPS,6,maiz
Guerrero,1542,1542,2007,6,D0,0,maiz
Hidalgo,22505,22363,2007,6,NPS,142,maiz
Jalisco,1168,1168,2007,6,D3,0,maiz
Michoacán de Ocampo,625,300,2007,6,D1,325,maiz
Nayarit,2251,2163,2007,6,D1,88,maiz
Nuevo León,3869,164,2007,6,NPS,3705,maiz
Oaxaca,49253,49064,2007,6,D0,189,maiz
Puebla,24591,16429,2007,6,D0,8162,maiz
Querétaro de Arteaga,15,15,2007,6,NPS,0,maiz
Quintana Roo,3332,3068,2007,6,D2,264,maiz
San Luis Potosí,10562,10446,2007,6,NPS,116,maiz
Sinaloa,11328,9743,2007,6,D1,1585,maiz
Tabasco,39152,35382,2007,6,D2,3770,maiz
Tamaulipas,7315,6310,2007,6,NPS,1005,maiz
Veracruz de Ignacio de la Llave,170905,154518,2007,6,D0,16387,maiz
Yucatán,540,529,2007,6,D1,11,maiz
Campeche,5062,4977,2007,7,D2,85,maiz
Chiapas,100730,100700,2007,7,NPS,30,maiz
Chihuahua,25,19,2007,7,D0,6,maiz
Guerrero,1542,1542,2007,7,NPS,0,maiz
Hidalgo,22505,22500,2007,7,NPS,5,maiz
Jalisco,1168,1168,2007,7,D1,0,maiz
Michoacán de Ocampo,625,300,2007,7,D3,325,maiz
Nayarit,2251,2246,2007,7,D1,5,maiz
Nuevo León,3809,1584,2007,7,NPS,2225,maiz
Oaxaca,49253,49064,2007,7,NPS,189,maiz
Puebla,24591,23787,2007,7,D1,804,maiz
Querétaro de Arteaga,15,15,2007,7,NPS,0,maiz
Quintana Roo,3332,3068,2007,7,D0,264,maiz
San Luis Potosí,10562,10446,2007,7,NPS,116,maiz
Sinaloa,11328,11213,2007,7,D2,115,maiz
Tabasco,39152,35382,2007,7,D3,3770,maiz
Tamaulipas,7315,6882,2007,7,NPS,433,maiz
Veracruz de Ignacio de la Llave,170957,168620,2007,7,D1,2337,maiz
Yucatán,540,540,2007,7,D0,0,maiz
Campeche,5062,4977,2007,8,NPS,85,maiz
Chiapas,100730,100700,2007,8,NPS,30,maiz
Chihuahua,25,19,2007,8,NPS,6,maiz
Guerrero,1542,1542,2007,8,NPS,0,maiz
Hidalgo,22505,22500,2007,8,NPS,5,maiz
Jalisco,1168,1168,2007,8,NPS,0,maiz
Michoacán de Ocampo,455,165,2007,8,NPS,290,maiz
Nayarit,2251,2246,2007,8,NPS,5,maiz
Nuevo León,3809,2561,2007,8,NPS,1248,maiz
Oaxaca,49253,49214,2007,8,NPS,39,maiz
Puebla,24591,24514,2007,8,NPS,77,maiz
Querétaro de Arteaga,15,15,2007,8,NPS,0,maiz
Quintana Roo,3332,3068,2007,8,NPS,264,maiz
San Luis Potosí,10562,10446,2007,8,NPS,116,maiz
Sinaloa,11328,11213,2007,8,NPS,115,maiz
Tabasco,39152,36361,2007,8,D1,2791,maiz
Tamaulipas,7315,7136,2007,8,NPS,179,maiz
Veracruz de Ignacio de la Llave,170957,170374,2007,8,NPS,583,maiz
Yucatán,540,540,2007,8,NPS,0,maiz
Campeche,5062,4977,2007,9,D1,85,maiz
Chiapas,100730,100700,2007,9,D0,30,maiz
Chihuahua,25,19,2007,9,D0,6,maiz
Guerrero,1542,1542,2007,9,NPS,0,maiz
Hidalgo,22505,22500,2007,9,NPS,5,maiz
Jalisco,1168,1168,2007,9,D0,0,maiz
Michoacán de Ocampo,455,455,2007,9,D0,0,maiz
Nayarit,2251,2246,2007,9,D0,5,maiz
Nuevo León,3809,2569,2007,9,NPS,1240,maiz
Oaxaca,49253,49214,2007,9,NPS,39,maiz
Puebla,24591,24514,2007,9,NPS,77,maiz
Querétaro de Arteaga,15,15,2007,9,NPS,0,maiz
Quintana Roo,3332,3068,2007,9,D1,264,maiz
San Luis Potosí,10562,10446,2007,9,NPS,116,maiz
Sinaloa,11328,11213,2007,9,NPS,115,maiz
Sonora,12,2,2007,9,NPS,10,maiz
Tabasco,39152,36361,2007,9,D1,2791,maiz
Tamaulipas,7315,7136,2007,9,NPS,179,maiz
Veracruz de Ignacio de la Llave,170957,170374,2007,9,NPS,583,maiz
Yucatán,540,540,2007,9,D0,0,maiz
Campeche,5062,4977,2007,12,NPS,85,maiz
Chiapas,100730,100700,2007,12,NPS,30,maiz
Chihuahua,25,19,2007,12,D0,6,maiz
Guerrero,1542,1542,2007,12,NPS,0,maiz
Hidalgo,22505,22500,2007,12,NPS,5,maiz
Jalisco,1168,1168,2007,12,D2,0,maiz
Michoacán de Ocampo,455,455,2007,12,NPS,0,maiz
Nayarit,2251,2246,2007,12,D1,5,maiz
Nuevo León,3809,2569,2007,12,D0,1240,maiz
Oaxaca,49253,49214,2007,12,NPS,39,maiz
Puebla,24591,24514,2007,12,NPS,77,maiz
Querétaro de Arteaga,15,15,2007,12,NPS,0,maiz
Quintana Roo,3332,3068,2007,12,D2,264,maiz
San Luis Potosí,10562,10446,2007,12,NPS,116,maiz
Sinaloa,11328,11213,2007,12,D1,115,maiz
Sonora,12,2,2007,12,NPS,10,maiz
Tabasco,39152,36361,2007,12,NPS,2791,maiz
Tamaulipas,7315,7136,2007,12,D0,179,maiz
Veracruz de Ignacio de la Llave,170957,170374,2007,12,NPS,583,maiz
Yucatán,540,540,2007,12,NPS,0,maiz
Chiapas,98120,52,2008,1,NPS,98068,maiz
Oaxaca,46849,500,2008,1,NPS,46349,maiz
Quintana Roo,3320,839,2008,1,D2,2481,maiz
Chiapas,102102,3837,2008,2,NPS,98265,maiz
Hidalgo,22406,351,2008,2,NPS,22055,maiz
Oaxaca,49576,24695,2008,2,NPS,24881,maiz
Quintana Roo,3320,2206,2008,2,D2,1114,maiz
Sinaloa,3281,48,2008,2,D1,3233,maiz
Tabasco,35140,620,2008,2,D0,34520,maiz
Veracruz de Ignacio de la Llave,205459,4484,2008,2,NPS,200975,maiz
Chiapas,102332,15842,2008,3,NPS,86490,maiz
Guerrero,1453,601,2008,3,D1,852,maiz
Hidalgo,22435,2848,2008,3,NPS,19587,maiz
Jalisco,1076,130,2008,3,D1,946,maiz
Nayarit,1576,264,2008,3,D2,1312,maiz
Oaxaca,49593,36747,2008,3,D0,12846,maiz
Quintana Roo,3320,2946,2008,3,D0,374,maiz
San Luis Potosí,11938,319,2008,3,NPS,11619,maiz
Sinaloa,3299,653,2008,3,D1,2646,maiz
Tabasco,35991,6816,2008,3,D1,29175,maiz
Veracruz de Ignacio de la Llave,194722,3350,2008,3,NPS,191372,maiz
Campeche,3882,1385,2008,4,D0,2497,maiz
Chiapas,102332,39228,2008,4,NPS,63104,maiz
Guerrero,1453,1453,2008,4,D1,0,maiz
Hidalgo,22435,13810,2008,4,NPS,8625,maiz
Jalisco,1076,756,2008,4,D1,320,maiz
Nayarit,1576,412,2008,4,D3,1164,maiz
Oaxaca,49593,42384,2008,4,NPS,7209,maiz
Quintana Roo,3320,2998,2008,4,D1,322,maiz
San Luis Potosí,12162,5349,2008,4,NPS,6813,maiz
Sinaloa,3299,1055,2008,4,D1,2244,maiz
Tabasco,37529,16394,2008,4,D2,21135,maiz
Tamaulipas,5349,510,2008,4,D0,4839,maiz
Veracruz de Ignacio de la Llave,194722,18129,2008,4,D0,176593,maiz
Yucatán,500,500,2008,4,NPS,0,maiz
Campeche,3882,3752,2008,5,D0,130,maiz
Chiapas,102332,83836,2008,5,NPS,18496,maiz
Chihuahua,23,8,2008,5,D0,15,maiz
Guerrero,1453,1453,2008,5,D1,0,maiz
Hidalgo,22435,21133,2008,5,D0,1302,maiz
Jalisco,1076,1012,2008,5,D1,64,maiz
Michoacán de Ocampo,148,140,2008,5,D3,8,maiz
Nayarit,1576,1128,2008,5,D3,448,maiz
Nuevo León,505,105,2008,5,D1,400,maiz
Oaxaca,49593,46564,2008,5,D0,3029,maiz
Puebla,24494,1040,2008,5,D0,23454,maiz
Quintana Roo,3320,2998,2008,5,D2,322,maiz
San Luis Potosí,12162,12034,2008,5,NPS,128,maiz
Sinaloa,3299,1110,2008,5,D1,2189,maiz
Tabasco,37839,25214,2008,5,D2,12625,maiz
Tamaulipas,5351,2128,2008,5,D1,3223,maiz
Veracruz de Ignacio de la Llave,194947,86995,2008,5,D2,107952,maiz
Yucatán,500,500,2008,5,NPS,0,maiz
Campeche,5232,5102,2008,6,D0,130,maiz
Chiapas,102332,89083,2008,6,NPS,13249,maiz
Chihuahua,23,8,2008,6,D1,15,maiz
Guerrero,1453,1453,2008,6,D0,0,maiz
Hidalgo,22435,22323,2008,6,D0,112,maiz
Jalisco,1076,1076,2008,6,D1,0,maiz
Michoacán de Ocampo,148,140,2008,6,D3,8,maiz
Nayarit,1576,1391,2008,6,D3,185,maiz
Nuevo León,505,266,2008,6,D2,239,maiz
Oaxaca,49593,49413,2008,6,NPS,180,maiz
Puebla,24494,22077,2008,6,D0,2417,maiz
Quintana Roo,3320,2998,2008,6,D1,322,maiz
San Luis Potosí,12162,12034,2008,6,NPS,128,maiz
Sinaloa,3299,1128,2008,6,D0,2171,maiz
Tabasco,37839,32398,2008,6,D0,5441,maiz
Tamaulipas,5351,2354,2008,6,NPS,2997,maiz
Veracruz de Ignacio de la Llave,194947,155460,2008,6,D0,39487,maiz
Yucatán,500,500,2008,6,NPS,0,maiz
Campeche,5232,5102,2008,7,D0,130,maiz
Chiapas,102332,97616,2008,7,NPS,4716,maiz
Chihuahua,23,8,2008,7,NPS,15,maiz
Guerrero,1453,1453,2008,7,NPS,0,maiz
Hidalgo,22435,22435,2008,7,NPS,0,maiz
Jalisco,1076,1076,2008,7,D1,0,maiz
Michoacán de Ocampo,148,140,2008,7,D1,8,maiz
Nayarit,1576,1391,2008,7,D2,185,maiz
Nuevo León,505,301,2008,7,NPS,204,maiz
Oaxaca,49593,49593,2008,7,NPS,0,maiz
Puebla,24494,23910,2008,7,NPS,584,maiz
Quintana Roo,3320,3320,2008,7,NPS,0,maiz
San Luis Potosí,12162,12034,2008,7,NPS,128,maiz
Sinaloa,3299,2038,2008,7,NPS,1261,maiz
Tabasco,37839,36684,2008,7,NPS,1155,maiz
Tamaulipas,5351,2418,2008,7,NPS,2933,maiz
Veracruz de Ignacio de la Llave,194947,169402,2008,7,D0,25545,maiz
Yucatán,500,500,2008,7,NPS,0,maiz
Campeche,5232,5102,2008,8,D1,130,maiz
Chiapas,102332,99522,2008,8,NPS,2810,maiz
Chihuahua,23,8,2008,8,NPS,15,maiz
Guerrero,1453,1453,2008,8,NPS,0,maiz
Hidalgo,22435,22435,2008,8,NPS,0,maiz
Jalisco,1076,1076,2008,8,D1,0,maiz
Michoacán de Ocampo,148,140,2008,8,D2,8,maiz
Nayarit,1576,1391,2008,8,D1,185,maiz
Nuevo León,505,301,2008,8,NPS,204,maiz
Oaxaca,49593,49593,2008,8,NPS,0,maiz
Puebla,24494,24434,2008,8,NPS,60,maiz
Quintana Roo,3320,3320,2008,8,NPS,0,maiz
San Luis Potosí,12162,12034,2008,8,NPS,128,maiz
Sinaloa,3299,2720,2008,8,NPS,579,maiz
Tabasco,37839,36684,2008,8,NPS,1155,maiz
Tamaulipas,5351,2447,2008,8,NPS,2904,maiz
Veracruz de Ignacio de la Llave,194947,170502,2008,8,D0,24445,maiz
Yucatán,500,500,2008,8,NPS,0,maiz
Campeche,5232,5102,2008,9,D1,130,maiz
Chiapas,102332,99522,2008,9,NPS,2810,maiz
Chihuahua,23,8,2008,9,NPS,15,maiz
Guerrero,1453,1453,2008,9,NPS,0,maiz
Hidalgo,22435,22435,2008,9,NPS,0,maiz
Jalisco,1076,1076,2008,9,NPS,0,maiz
Michoacán de Ocampo,148,148,2008,9,D1,0,maiz
Nayarit,1576,1391,2008,9,NPS,185,maiz
Nuevo León,505,301,2008,9,NPS,204,maiz
Oaxaca,49593,49593,2008,9,NPS,0,maiz
Puebla,24494,24494,2008,9,NPS,0,maiz
Quintana Roo,3320,3320,2008,9,NPS,0,maiz
San Luis Potosí,12162,12034,2008,9,NPS,128,maiz
Sinaloa,3299,2720,2008,9,NPS,579,maiz
Tabasco,37839,36684,2008,9,NPS,1155,maiz
Tamaulipas,5351,2447,2008,9,NPS,2904,maiz
Veracruz de Ignacio de la Llave,194947,172547,2008,9,D0,22400,maiz
Yucatán,500,500,2008,9,NPS,0,maiz
Campeche,5232,5102,2008,12,D0,130,maiz
Chiapas,102332,99522,2008,12,D0,2810,maiz
Chihuahua,23,8,2008,12,NPS,15,maiz
Guerrero,1453,1453,2008,12,NPS,0,maiz
Hidalgo,22435,22435,2008,12,NPS,0,maiz
Jalisco,1076,1076,2008,12,D0,0,maiz
Michoacán de Ocampo,148,148,2008,12,D1,0,maiz
Nayarit,1576,1391,2008,12,D0,185,maiz
Nuevo León,505,301,2008,12,NPS,204,maiz
Oaxaca,49593,49593,2008,12,NPS,0,maiz
Puebla,24494,24494,2008,12,NPS,0,maiz
Quintana Roo,3320,3320,2008,12,D0,0,maiz
San Luis Potosí,12162,12034,2008,12,NPS,128,maiz
Sinaloa,3299,2720,2008,12,NPS,579,maiz
Tabasco,37839,36684,2008,12,D1,1155,maiz
Tamaulipas,5351,2447,2008,12,NPS,2904,maiz
Veracruz de Ignacio de la Llave,194947,172547,2008,12,D0,22400,maiz
Yucatán,500,500,2008,12,D0,0,maiz
Chiapas,98900,890,2009,1,D0,98010,maiz
Oaxaca,44819,4020,2009,1,NPS,40799,maiz
Quintana Roo,3542,104,2009,1,NPS,3438,maiz
Chiapas,102038,6152,2009,2,D0,95886,maiz
Hidalgo,22946,5955,2009,2,NPS,16991,maiz
Jalisco,981,280,2009,2,NPS,701,maiz
Oaxaca,46984,15851,2009,2,NPS,31133,maiz
Quintana Roo,3631,794,2009,2,D0,2837,maiz
Veracruz de Ignacio de la Llave,173502,7371,2009,2,D0,166131,maiz
Chiapas,102641,23888,2009,3,D0,78753,maiz
Guerrero,1461,589,2009,3,NPS,872,maiz
Hidalgo,23002,6399,2009,3,NPS,16603,maiz
Jalisco,981,402,2009,3,D1,579,maiz
Nayarit,3234,499,2009,3,D0,2735,maiz
Oaxaca,47009,22211,2009,3,NPS,24798,maiz
Quintana Roo,3631,2038,2009,3,D0,1593,maiz
Sinaloa,2994,427,2009,3,D1,2567,maiz
Tabasco,34010,3308,2009,3,D1,30702,maiz
Tamaulipas,7177,2566,2009,3,NPS,4611,maiz
Veracruz de Ignacio de la Llave,190458,10622,2009,3,NPS,179836,maiz
Yucatán,512,500,2009,3,D1,12,maiz
Campeche,4500,3515,2009,4,D1,985,maiz
Chiapas,102641,46308,2009,4,D0,56333,maiz
Guerrero,1461,1461,2009,4,NPS,0,maiz
Hidalgo,23002,8622,2009,4,NPS,14380,maiz
Jalisco,1181,724,2009,4,D1,457,maiz
Michoacán de Ocampo,36,31,2009,4,D1,5,maiz
Nayarit,3234,953,2009,4,D0,2281,maiz
Oaxaca,47034,37785,2009,4,NPS,9249,maiz
Quintana Roo,3631,3110,2009,4,D0,521,maiz
San Luis Potosí,14031,8644,2009,4,NPS,5387,maiz
Sinaloa,3139,2217,2009,4,NPS,922,maiz
Tabasco,34110,13410,2009,4,D1,20700,maiz
Tamaulipas,7177,6630,2009,4,NPS,547,maiz
Veracruz de Ignacio de la Llave,190878,50938,2009,4,D0,139940,maiz
Yucatán,512,500,2009,4,D2,12,maiz
Campeche,4650,3689,2009,5,D1,961,maiz
Chiapas,102911,60786,2009,5,NPS,42125,maiz
Guerrero,1461,1461,2009,5,NPS,0,maiz
Hidalgo,23002,21487,2009,5,NPS,1515,maiz
Jalisco,1181,1121,2009,5,D1,60,maiz
Michoacán de Ocampo,36,31,2009,5,D1,5,maiz
Nayarit,3234,1594,2009,5,D0,1640,maiz
Oaxaca,47034,44880,2009,5,NPS,2154,maiz
Quintana Roo,3631,3299,2009,5,D1,332,maiz
San Luis Potosí,14031,13876,2009,5,NPS,155,maiz
Sinaloa,3204,2217,2009,5,D0,987,maiz
Tabasco,34110,32638,2009,5,D1,1472,maiz
Tamaulipas,7177,6880,2009,5,NPS,297,maiz
Veracruz de Ignacio de la Llave,191242,95988,2009,5,D0,95254,maiz
Yucatán,512,500,2009,5,D2,12,maiz
Campeche,4650,3694,2009,6,D1,956,maiz
Chiapas,102911,75176,2009,6,NPS,27735,maiz
Guerrero,1461,1461,2009,6,NPS,0,maiz
Hidalgo,23002,22983,2009,6,D0,19,maiz
Jalisco,1181,1181,2009,6,D1,0,maiz
Michoacán de Ocampo,36,36,2009,6,D1,0,maiz
Nayarit,3234,3192,2009,6,D0,42,maiz
Nuevo León,1859,403,2009,6,NPS,1456,maiz
Oaxaca,47034,46809,2009,6,NPS,225,maiz
Puebla,22757,13907,2009,6,D0,8850,maiz
Quintana Roo,3631,3628,2009,6,D1,3,maiz
San Luis Potosí,14031,13876,2009,6,NPS,155,maiz
Sinaloa,3204,2378,2009,6,NPS,826,maiz
Tabasco,34110,32718,2009,6,D1,1392,maiz
Tamaulipas,7177,6880,2009,6,NPS,297,maiz
Veracruz de Ignacio de la Llave,191242,167962,2009,6,D0,23280,maiz
Yucatán,500,500,2009,6,D2,0,maiz
Campeche,4650,3694,2009,7,D2,956,maiz
Chiapas,102911,97046,2009,7,D0,5865,maiz
Guerrero,1461,1461,2009,7,NPS,0,maiz
Hidalgo,23002,23002,2009,7,D0,0,maiz
Jalisco,1181,1181,2009,7,D1,0,maiz
Michoacán de Ocampo,36,36,2009,7,D2,0,maiz
Nayarit,3234,3192,2009,7,D0,42,maiz
Nuevo León,1859,839,2009,7,D0,1020,maiz
Oaxaca,47034,47034,2009,7,NPS,0,maiz
Puebla,22757,22312,2009,7,D0,445,maiz
Quintana Roo,3631,3631,2009,7,D1,0,maiz
San Luis Potosí,14031,13876,2009,7,NPS,155,maiz
Sinaloa,3204,2698,2009,7,NPS,506,maiz
Tabasco,34110,32976,2009,7,D1,1134,maiz
Tamaulipas,7177,7088,2009,7,D0,89,maiz
Veracruz de Ignacio de la Llave,191242,181158,2009,7,D0,10084,maiz
Yucatán,500,500,2009,7,D2,0,maiz
Campeche,4650,3804,2009,8,D2,846,maiz
Chiapas,102911,99884,2009,8,D1,3027,maiz
Guerrero,1461,1461,2009,8,D0,0,maiz
Hidalgo,23002,23002,2009,8,D1,0,maiz
Jalisco,1181,1181,2009,8,D2,0,maiz
Michoacán de Ocampo,36,36,2009,8,D2,0,maiz
Nayarit,3234,3234,2009,8,D1,0,maiz
Nuevo León,1859,839,2009,8,D0,1020,maiz
Oaxaca,47034,47034,2009,8,D0,0,maiz
Puebla,22757,22757,2009,8,D1,0,maiz
Quintana Roo,3631,3631,2009,8,D0,0,maiz
San Luis Potosí,14031,13876,2009,8,NPS,155,maiz
Sinaloa,3204,2698,2009,8,NPS,506,maiz
Tabasco,34110,32976,2009,8,D2,1134,maiz
Tamaulipas,7177,7117,2009,8,D3,60,maiz
Veracruz de Ignacio de la Llave,191242,181218,2009,8,D1,10024,maiz
Yucatán,500,500,2009,8,D2,0,maiz
Campeche,4650,4154,2009,9,D3,496,maiz
Chiapas,102911,102911,2009,9,D2,0,maiz
Guerrero,1461,1461,2009,9,NPS,0,maiz
Hidalgo,23002,23002,2009,9,NPS,0,maiz
Jalisco,1181,1181,2009,9,D1,0,maiz
Michoacán de Ocampo,36,36,2009,9,D2,0,maiz
Nayarit,3234,3234,2009,9,D1,0,maiz
Nuevo León,1859,839,2009,9,D1,1020,maiz
Oaxaca,47034,47034,2009,9,NPS,0,maiz
Puebla,22757,22757,2009,9,NPS,0,maiz
Quintana Roo,3631,3631,2009,9,D2,0,maiz
San Luis Potosí,14031,13876,2009,9,NPS,155,maiz
Sinaloa,3204,2835,2009,9,NPS,369,maiz
Tabasco,34110,32976,2009,9,D3,1134,maiz
Tamaulipas,7177,7117,2009,9,D1,60,maiz
Veracruz de Ignacio de la Llave,191242,189906,2009,9,NPS,1336,maiz
Yucatán,500,500,2009,9,D3,0,maiz
Campeche,4650,4154,2009,12,D2,496,maiz
Chiapas,102911,102911,2009,12,D2,0,maiz
Guerrero,1461,1461,2009,12,NPS,0,maiz
Hidalgo,23002,23002,2009,12,NPS,0,maiz
Jalisco,1181,1181,2009,12,D1,0,maiz
Michoacán de Ocampo,36,36,2009,12,D2,0,maiz
Nayarit,3234,3234,2009,12,NPS,0,maiz
Nuevo León,1859,839,2009,12,NPS,1020,maiz
Oaxaca,47034,47034,2009,12,NPS,0,maiz
Puebla,22757,22757,2009,12,D0,0,maiz
Quintana Roo,3631,3631,2009,12,D0,0,maiz
San Luis Potosí,14031,13876,2009,12,NPS,155,maiz
Sinaloa,3204,2835,2009,12,D0,369,maiz
Tabasco,34110,32976,2009,12,D3,1134,maiz
Tamaulipas,7177,7117,2009,12,D0,60,maiz
Veracruz de Ignacio de la Llave,191242,189906,2009,12,NPS,1336,maiz
Yucatán,500,500,2009,12,D3,0,maiz
Chiapas,93323,3500,2010,1,D2,89823,maiz
Oaxaca,43678,1019,2010,1,NPS,42659,maiz
Quintana Roo,3760,597,2010,1,D0,3163,maiz
Veracruz de Ignacio de la Llave,160217,1134,2010,1,NPS,159083,maiz
Yucatán,1302,320,2010,1,D3,982,maiz
Campeche,5610,815,2010,2,D2,4795,maiz
Chiapas,101405,4481,2010,2,D3,96924,maiz
Hidalgo,19671,5610,2010,2,NPS,14061,maiz
Oaxaca,44493,23992,2010,2,NPS,20501,maiz
Quintana Roo,3760,2306,2010,2,D1,1454,maiz
San Luis Potosí,12906,300,2010,2,NPS,12606,maiz
Tabasco,34845,6593,2010,2,D3,28252,maiz
Veracruz de Ignacio de la Llave,181650,2804,2010,2,NPS,178846,maiz
Yucatán,1302,320,2010,2,D3,982,maiz
Campeche,5640,2085,2010,3,D2,3555,maiz
Chiapas,101405,24426,2010,3,D2,76979,maiz
Guerrero,1453,647,2010,3,NPS,806,maiz
Hidalgo,22783,8902,2010,3,NPS,13881,maiz
Jalisco,1483,200,2010,3,NPS,1283,maiz
Nayarit,3242,74,2010,3,NPS,3168,maiz
Oaxaca,44493,29060,2010,3,NPS,15433,maiz
Quintana Roo,3760,3620,2010,3,D1,140,maiz
San Luis Potosí,13886,1480,2010,3,NPS,12406,maiz
Tabasco,35137,13090,2010,3,D2,22047,maiz
Tamaulipas,3006,560,2010,3,NPS,2446,maiz
Veracruz de Ignacio de la Llave,183383,8777,2010,3,NPS,174606,maiz
Yucatán,1302,920,2010,3,D2,382,maiz
Campeche,5640,3782,2010,4,D2,1858,maiz
Chiapas,101405,46648,2010,4,D3,54757,maiz
Guerrero,1453,1453,2010,4,NPS,0,maiz
Hidalgo,22783,16616,2010,4,NPS,6167,maiz
Jalisco,1483,1151,2010,4,NPS,332,maiz
Michoacán de Ocampo,136,136,2010,4,NPS,0,maiz
Nayarit,3242,74,2010,4,NPS,3168,maiz
Oaxaca,44493,34307,2010,4,NPS,10186,maiz
Quintana Roo,3760,3760,2010,4,D1,0,maiz
San Luis Potosí,13886,4394,2010,4,NPS,9492,maiz
Sinaloa,902,259,2010,4,NPS,643,maiz
Tabasco,35427,22783,2010,4,D3,12644,maiz
Tamaulipas,4457,1950,2010,4,NPS,2507,maiz
Veracruz de Ignacio de la Llave,185023,47349,2010,4,NPS,137674,maiz
Yucatán,1302,920,2010,4,D3,382,maiz
Campeche,5640,4039,2010,5,D2,1601,maiz
Chiapas,101405,63206,2010,5,D2,38199,maiz
Chihuahua,34,20,2010,5,NPS,14,maiz
Guerrero,1453,1453,2010,5,NPS,0,maiz
Hidalgo,22783,20865,2010,5,NPS,1918,maiz
Jalisco,1483,1266,2010,5,NPS,217,maiz
Michoacán de Ocampo,136,136,2010,5,NPS,0,maiz
Nayarit,3242,1795,2010,5,NPS,1447,maiz
Oaxaca,44493,42570,2010,5,NPS,1923,maiz
Puebla,29025,2160,2010,5,NPS,26865,maiz
Quintana Roo,3760,3760,2010,5,D1,0,maiz
San Luis Potosí,13886,7479,2010,5,NPS,6407,maiz
Sinaloa,902,587,2010,5,D2,315,maiz
Tabasco,35554,30810,2010,5,D3,4744,maiz
Tamaulipas,4957,3666,2010,5,NPS,1291,maiz
Veracruz de Ignacio de la Llave,185523,134551,2010,5,NPS,50972,maiz
Yucatán,1302,920,2010,5,D2,382,maiz
Campeche,5640,4046,2010,6,D2,1594,maiz
Chiapas,101405,87226,2010,6,D2,14179,maiz
Chihuahua,34,20,2010,6,NPS,14,maiz
Guerrero,1453,1453,2010,6,NPS,0,maiz
Hidalgo,22783,22521,2010,6,NPS,262,maiz
Jalisco,1483,1418,2010,6,NPS,65,maiz
Michoacán de Ocampo,136,136,2010,6,NPS,0,maiz
Nayarit,3242,1858,2010,6,NPS,1384,maiz
Nuevo León,1412,1330,2010,6,NPS,82,maiz
Oaxaca,44493,43840,2010,6,NPS,653,maiz
Puebla,29025,19903,2010,6,NPS,9122,maiz
Querétaro de Arteaga,10,10,2010,6,NPS,0,maiz
Quintana Roo,3760,3760,2010,6,D1,0,maiz
San Luis Potosí,13886,12080,2010,6,NPS,1806,maiz
Sinaloa,902,882,2010,6,D2,20,maiz
Tabasco,35554,35194,2010,6,D2,360,maiz
Tamaulipas,4957,3916,2010,6,NPS,1041,maiz
Veracruz de Ignacio de la Llave,185523,169028,2010,6,D0,16495,maiz
Yucatán,1302,920,2010,6,D1,382,maiz
Campeche,5640,4046,2010,7,D0,1594,maiz
Chiapas,101405,96293,2010,7,NPS,5112,maiz
Chihuahua,34,20,2010,7,NPS,14,maiz
Guerrero,1453,1453,2010,7,NPS,0,maiz
Hidalgo,22783,22783,2010,7,NPS,0,maiz
Jalisco,1483,1478,2010,7,NPS,5,maiz
Michoacán de Ocampo,136,136,2010,7,NPS,0,maiz
Nayarit,3242,2917,2010,7,NPS,325,maiz
Nuevo León,1412,1330,2010,7,NPS,82,maiz
Oaxaca,44493,44200,2010,7,NPS,293,maiz
Puebla,29025,25166,2010,7,NPS,3859,maiz
Querétaro de Arteaga,10,10,2010,7,NPS,0,maiz
Quintana Roo,3760,3760,2010,7,D1,0,maiz
San Luis Potosí,13886,12080,2010,7,NPS,1806,maiz
Sinaloa,902,902,2010,7,NPS,0,maiz
Sonora,20,3,2010,7,NPS,17,maiz
Tabasco,35554,35194,2010,7,NPS,360,maiz
Tamaulipas,4957,4271,2010,7,NPS,686,maiz
Veracruz de Ignacio de la Llave,185523,181148,2010,7,NPS,4375,maiz
Yucatán,1302,920,2010,7,D0,382,maiz
Campeche,5640,5541,2010,8,NPS,99,maiz
Chiapas,101405,96945,2010,8,NPS,4460,maiz
Chihuahua,34,20,2010,8,NPS,14,maiz
Guerrero,1453,1453,2010,8,NPS,0,maiz
Hidalgo,22783,22783,2010,8,NPS,0,maiz
Jalisco,1483,1478,2010,8,NPS,5,maiz
Michoacán de Ocampo,136,136,2010,8,NPS,0,maiz
Nayarit,3242,2917,2010,8,NPS,325,maiz
Nuevo León,1412,1346,2010,8,NPS,66,maiz
Oaxaca,44493,44200,2010,8,NPS,293,maiz
Puebla,29025,28528,2010,8,NPS,497,maiz
Querétaro de Arteaga,10,10,2010,8,NPS,0,maiz
Quintana Roo,3760,3760,2010,8,NPS,0,maiz
San Luis Potosí,13886,12080,2010,8,NPS,1806,maiz
Sinaloa,902,902,2010,8,NPS,0,maiz
Sonora,20,3,2010,8,NPS,17,maiz
Tabasco,35554,35194,2010,8,NPS,360,maiz
Tamaulipas,4957,4631,2010,8,NPS,326,maiz
Veracruz de Ignacio de la Llave,185523,183274,2010,8,NPS,2249,maiz
Yucatán,1302,920,2010,8,NPS,382,maiz
Campeche,5640,5541,2010,9,NPS,99,maiz
Chiapas,101405,101405,2010,9,NPS,0,maiz
Chihuahua,34,20,2010,9,NPS,14,maiz
Guerrero,1453,1453,2010,9,NPS,0,maiz
Hidalgo,22783,22783,2010,9,NPS,0,maiz
Jalisco,1483,1478,2010,9,NPS,5,maiz
Michoacán de Ocampo,136,136,2010,9,NPS,0,maiz
Nayarit,3242,2917,2010,9,NPS,325,maiz
Nuevo León,1412,1346,2010,9,NPS,66,maiz
Oaxaca,44493,44200,2010,9,NPS,293,maiz
Puebla,29025,28923,2010,9,NPS,102,maiz
Querétaro de Arteaga,10,10,2010,9,NPS,0,maiz
Quintana Roo,3760,3760,2010,9,NPS,0,maiz
San Luis Potosí,13886,12080,2010,9,NPS,1806,maiz
Sinaloa,902,902,2010,9,D0,0,maiz
Sonora,23,3,2010,9,NPS,20,maiz
Tabasco,35554,35194,2010,9,NPS,360,maiz
Tamaulipas,4957,4697,2010,9,NPS,260,maiz
Veracruz de Ignacio de la Llave,185523,183856,2010,9,NPS,1667,maiz
Yucatán,1302,920,2010,9,NPS,382,maiz
Campeche,5640,5541,2010,12,NPS,99,maiz
Chiapas,101405,101405,2010,12,NPS,0,maiz
Chihuahua,34,20,2010,12,D0,14,maiz
Guerrero,1453,1453,2010,12,NPS,0,maiz
Hidalgo,22783,22783,2010,12,NPS,0,maiz
Jalisco,1483,1478,2010,12,NPS,5,maiz
Michoacán de Ocampo,136,136,2010,12,NPS,0,maiz
Nayarit,3242,2917,2010,12,NPS,325,maiz
Nuevo León,1412,1346,2010,12,NPS,66,maiz
Oaxaca,44493,44200,2010,12,NPS,293,maiz
Puebla,29025,28923,2010,12,NPS,102,maiz
Querétaro de Arteaga,10,10,2010,12,NPS,0,maiz
Quintana Roo,3760,3760,2010,12,NPS,0,maiz
San Luis Potosí,13886,12080,2010,12,NPS,1806,maiz
Sinaloa,902,902,2010,12,D0,0,maiz
Sonora,23,3,2010,12,D0,20,maiz
Tabasco,35554,35194,2010,12,NPS,360,maiz
Tamaulipas,4957,4697,2010,12,NPS,260,maiz
Veracruz de Ignacio de la Llave,185523,183856,2010,12,NPS,1667,maiz
Yucatán,1302,920,2010,12,D0,382,maiz
Chiapas,94775,1830,2011,1,NPS,92945,maiz
Oaxaca,44943,1727,2011,1,NPS,43216,maiz
Quintana Roo,3215,173,2011,1,NPS,3042,maiz
Veracruz de Ignacio de la Llave,148290,541,2011,1,NPS,147749,maiz
Campeche,4070,110,2011,2,D0,3960,maiz
Chiapas,97464,4209,2011,2,NPS,93255,maiz
Hidalgo,19339,7309,2011,2,NPS,12030,maiz
Oaxaca,45463,3685,2011,2,NPS,41778,maiz
Quintana Roo,3870,1954,2011,2,D0,1916,maiz
Tabasco,35924,1892,2011,2,NPS,34032,maiz
Veracruz de Ignacio de la Llave,177402,736,2011,2,NPS,176666,maiz
Campeche,5850,725,2011,3,D0,5125,maiz
Chiapas,97464,12275,2011,3,NPS,85189,maiz
Guerrero,1453,385,2011,3,D0,1068,maiz
Hidalgo,19562,10780,2011,3,D0,8782,maiz
Jalisco,785,205,2011,3,D0,580,maiz
Nayarit,3023,58,2011,3,D0,2965,maiz
Oaxaca,45463,10764,2011,3,D1,34699,maiz
Quintana Roo,3870,3069,2011,3,D0,801,maiz
Tabasco,38532,14983,2011,3,NPS,23549,maiz
Tamaulipas,3741,205,2011,3,D0,3536,maiz
Veracruz de Ignacio de la Llave,182352,4802,2011,3,NPS,177550,maiz
Campeche,5850,3215,2011,4,D1,2635,maiz
Chiapas,100089,45294,2011,4,D1,54795,maiz
Guerrero,1453,1453,2011,4,D0,0,maiz
Hidalgo,19562,13985,2011,4,D2,5577,maiz
Jalisco,785,441,2011,4,D2,344,maiz
Michoacán de Ocampo,392,5,2011,4,D1,387,maiz
Nayarit,3023,542,2011,4,D2,2481,maiz
Oaxaca,45463,32800,2011,4,D0,12663,maiz
Quintana Roo,3870,3400,2011,4,D1,470,maiz
San Luis Potosí,11923,2789,2011,4,D2,9134,maiz
Sinaloa,2530,328,2011,4,D2,2202,maiz
Tabasco,39232,22123,2011,4,D1,17109,maiz
Tamaulipas,3741,875,2011,4,D3,2866,maiz
Veracruz de Ignacio de la Llave,182352,46659,2011,4,D1,135693,maiz
Campeche,5850,5200,2011,5,D3,650,maiz
Chiapas,100089,83609,2011,5,NPS,16480,maiz
Guerrero,1453,1453,2011,5,D0,0,maiz
Hidalgo,19562,15322,2011,5,D2,4240,maiz
Jalisco,785,785,2011,5,D2,0,maiz
Michoacán de Ocampo,392,105,2011,5,D1,287,maiz
Nayarit,3023,1482,2011,5,D2,1541,maiz
Oaxaca,45463,43816,2011,5,D0,1647,maiz
Quintana Roo,3870,3520,2011,5,D2,350,maiz
San Luis Potosí,11923,6973,2011,5,D2,4950,maiz
Sinaloa,2530,328,2011,5,D2,2202,maiz
Tabasco,39232,33430,2011,5,D1,5802,maiz
Tamaulipas,3741,1366,2011,5,D3,2375,maiz
Veracruz de Ignacio de la Llave,182352,128111,2011,5,D1,54241,maiz
Campeche,5850,5750,2011,6,D2,100,maiz
Chiapas,100089,92616,2011,6,D0,7473,maiz
Guerrero,1453,1453,2011,6,NPS,0,maiz
Hidalgo,19562,18148,2011,6,D2,1414,maiz
Jalisco,785,785,2011,6,D2,0,maiz
Michoacán de Ocampo,392,142,2011,6,D3,250,maiz
Nayarit,3023,2636,2011,6,D2,387,maiz
Nuevo León,756,703,2011,6,D3,53,maiz
Oaxaca,45463,45103,2011,6,NPS,360,maiz
Puebla,28524,18113,2011,6,D2,10411,maiz
Quintana Roo,3870,3520,2011,6,D2,350,maiz
San Luis Potosí,11923,11838,2011,6,D2,85,maiz
Sinaloa,3310,328,2011,6,D2,2982,maiz
Tabasco,39232,39037,2011,6,D1,195,maiz
Tamaulipas,3741,1366,2011,6,D2,2375,maiz
Veracruz de Ignacio de la Llave,182982,152859,2011,6,D3,30123,maiz
Campeche,5850,5760,2011,7,D1,90,maiz
Chiapas,100089,100089,2011,7,NPS,0,maiz
Guerrero,1453,1453,2011,7,NPS,0,maiz
Hidalgo,19562,19562,2011,7,D1,0,maiz
Jalisco,785,785,2011,7,D2,0,maiz
Michoacán de Ocampo,392,142,2011,7,D2,250,maiz
Nayarit,3023,3023,2011,7,D2,0,maiz
Nuevo León,756,756,2011,7,D2,0,maiz
Oaxaca,45463,45463,2011,7,NPS,0,maiz
Puebla,28524,22600,2011,7,D1,5924,maiz
Quintana Roo,3870,3520,2011,7,D1,350,maiz
San Luis Potosí,11923,11838,2011,7,D2,85,maiz
Sinaloa,2530,328,2011,7,D1,2202,maiz
Sonora,16,6,2011,7,D3,10,maiz
Tabasco,39232,39038,2011,7,D1,194,maiz
Tamaulipas,3741,1616,2011,7,D1,2125,maiz
Veracruz de Ignacio de la Llave,182982,162707,2011,7,D1,20275,maiz
Campeche,5850,5760,2011,8,D1,90,maiz
Chiapas,100089,100089,2011,8,NPS,0,maiz
Guerrero,1453,1453,2011,8,NPS,0,maiz
Hidalgo,19562,19562,2011,8,D1,0,maiz
Jalisco,785,785,2011,8,D2,0,maiz
Michoacán de Ocampo,392,142,2011,8,D2,250,maiz
Nayarit,3023,3023,2011,8,D1,0,maiz
Nuevo León,756,756,2011,8,D3,0,maiz
Oaxaca,45463,45463,2011,8,NPS,0,maiz
Puebla,28524,22913,2011,8,D0,5611,maiz
Quintana Roo,3870,3520,2011,8,NPS,350,maiz
San Luis Potosí,11923,11838,2011,8,D1,85,maiz
Sinaloa,2530,1497,2011,8,D1,1033,maiz
Sonora,16,6,2011,8,D2,10,maiz
Tabasco,39232,39038,2011,8,D1,194,maiz
Tamaulipas,3741,1616,2011,8,D1,2125,maiz
Veracruz de Ignacio de la Llave,182982,165744,2011,8,D1,17238,maiz
Campeche,5850,5760,2011,9,NPS,90,maiz
Chiapas,100089,100089,2011,9,NPS,0,maiz
Guerrero,1453,1453,2011,9,NPS,0,maiz
Hidalgo,19562,19562,2011,9,NPS,0,maiz
Jalisco,785,785,2011,9,NPS,0,maiz
Michoacán de Ocampo,392,142,2011,9,D1,250,maiz
Nayarit,3023,3023,2011,9,NPS,0,maiz
Nuevo León,756,756,2011,9,D3,0,maiz
Oaxaca,45463,45463,2011,9,NPS,0,maiz
Puebla,28524,22913,2011,9,NPS,5611,maiz
Quintana Roo,3870,3520,2011,9,NPS,350,maiz
San Luis Potosí,11923,11838,2011,9,D2,85,maiz
Sinaloa,2530,2397,2011,9,NPS,133,maiz
Sonora,16,6,2011,9,D3,10,maiz
Tabasco,39232,39038,2011,9,NPS,194,maiz
Tamaulipas,3741,1616,2011,9,D1,2125,maiz
Veracruz de Ignacio de la Llave,182982,165917,2011,9,NPS,17065,maiz
Campeche,5850,5760,2011,12,NPS,90,maiz
Chiapas,100089,100089,2011,12,NPS,0,maiz
Guerrero,1453,1453,2011,12,NPS,0,maiz
Hidalgo,19562,19562,2011,12,D0,0,maiz
Jalisco,785,785,2011,12,D0,0,maiz
Michoacán de Ocampo,392,142,2011,12,D0,250,maiz
Nayarit,3023,3023,2011,12,NPS,0,maiz
Nuevo León,756,756,2011,12,D3,0,maiz
Oaxaca,45463,45463,2011,12,NPS,0,maiz
Puebla,28524,22913,2011,12,NPS,5611,maiz
Quintana Roo,3870,3520,2011,12,NPS,350,maiz
San Luis Potosí,11923,11838,2011,12,D0,85,maiz
Sinaloa,2530,2397,2011,12,D1,133,maiz
Sonora,16,6,2011,12,D0,10,maiz
Tabasco,39232,39038,2011,12,NPS,194,maiz
Tamaulipas,3741,1616,2011,12,D0,2125,maiz
Veracruz de Ignacio de la Llave,182982,165917,2011,12,D0,17065,maiz
Chiapas,89986,5054,2012,1,NPS,84932,maiz
Quintana Roo,1530,185,2012,1,NPS,1345,maiz
Chiapas,89330,6421,2012,2,NPS,82909,maiz
Michoacán de Ocampo,144,120,2012,2,NPS,24,maiz
Oaxaca,46238,5178,2012,2,NPS,41060,maiz
Quintana Roo,1900,678,2012,2,NPS,1222,maiz
Veracruz de Ignacio de la Llave,167535,389,2012,2,NPS,167146,maiz
Campeche,4388,835,2012,3,D0,3553,maiz
Chiapas,91943,6801,2012,3,NPS,85142,maiz
Guerrero,881,591,2012,3,NPS,290,maiz
Hidalgo,23913,3363,2012,3,NPS,20550,maiz
Jalisco,739,20,2012,3,NPS,719,maiz
Michoacán de Ocampo,144,131,2012,3,NPS,13,maiz
Nayarit,979,57,2012,3,D0,922,maiz
Oaxaca,46238,20504,2012,3,NPS,25734,maiz
Quintana Roo,3750,1530,2012,3,NPS,2220,maiz
Tabasco,41653,11127,2012,3,NPS,30526,maiz
Veracruz de Ignacio de la Llave,194258,5485,2012,3,NPS,188773,maiz
Yucatán,211,200,2012,3,D0,11,maiz
Campeche,4388,2523,2012,4,NPS,1865,maiz
Chiapas,93059,29953,2012,4,NPS,63106,maiz
Guerrero,1450,1300,2012,4,NPS,150,maiz
Hidalgo,23913,9644,2012,4,NPS,14269,maiz
Jalisco,739,402,2012,4,NPS,337,maiz
Michoacán de Ocampo,144,144,2012,4,NPS,0,maiz
Nayarit,979,248,2012,4,D1,731,maiz
Nuevo León,1041,150,2012,4,D0,891,maiz
Oaxaca,46238,35100,2012,4,NPS,11138,maiz
Puebla,20406,420,2012,4,NPS,19986,maiz
Quintana Roo,3750,2537,2012,4,NPS,1213,maiz
San Luis Potosí,10139,1127,2012,4,NPS,9012,maiz
Tabasco,41653,23512,2012,4,NPS,18141,maiz
Veracruz de Ignacio de la Llave,194258,55330,2012,4,NPS,138928,maiz
Yucatán,211,200,2012,4,NPS,11,maiz
Campeche,4388,2523,2012,5,NPS,1865,maiz
Chiapas,100781,57757,2012,5,NPS,43024,maiz
Chihuahua,33,8,2012,5,D2,25,maiz
Guerrero,1450,1450,2012,5,NPS,0,maiz
Hidalgo,23913,22727,2012,5,NPS,1186,maiz
Jalisco,739,647,2012,5,NPS,92,maiz
Michoacán de Ocampo,144,144,2012,5,NPS,0,maiz
Nayarit,979,540,2012,5,D1,439,maiz
Nuevo León,1066,150,2012,5,NPS,916,maiz
Oaxaca,46238,44214,2012,5,NPS,2024,maiz
Puebla,20406,420,2012,5,NPS,19986,maiz
Quintana Roo,3750,3750,2012,5,NPS,0,maiz
San Luis Potosí,10139,9034,2012,5,NPS,1105,maiz
Sinaloa,2607,490,2012,5,D0,2117,maiz
Tabasco,41653,33839,2012,5,NPS,7814,maiz
Tamaulipas,1777,810,2012,5,NPS,967,maiz
Veracruz de Ignacio de la Llave,194283,161262,2012,5,NPS,33021,maiz
Yucatán,211,200,2012,5,NPS,11,maiz
Campeche,4388,4008,2012,6,NPS,380,maiz
Chiapas,100786,98082,2012,6,NPS,2704,maiz
Chihuahua,33,8,2012,6,D2,25,maiz
Guanajuato,42,42,2012,6,D0,0,maiz
Guerrero,1450,1450,2012,6,NPS,0,maiz
Hidalgo,23913,23603,2012,6,NPS,310,maiz
Jalisco,739,739,2012,6,NPS,0,maiz
Michoacán de Ocampo,144,144,2012,6,NPS,0,maiz
Nayarit,753,753,2012,6,NPS,0,maiz
Nuevo León,1066,273,2012,6,NPS,793,maiz
Oaxaca,46238,46045,2012,6,NPS,193,maiz
Puebla,20406,420,2012,6,NPS,19986,maiz
Quintana Roo,3750,3750,2012,6,NPS,0,maiz
San Luis Potosí,10139,9781,2012,6,NPS,358,maiz
Sinaloa,6243,1168,2012,6,NPS,5075,maiz
Sonora,6,6,2012,6,D1,0,maiz
Tabasco,41653,40781,2012,6,NPS,872,maiz
Tamaulipas,1777,1206,2012,6,NPS,571,maiz
Veracruz de Ignacio de la Llave,194283,186644,2012,6,NPS,7639,maiz
Yucatán,211,200,2012,6,NPS,11,maiz
Campeche,4388,4128,2012,7,NPS,260,maiz
Chiapas,100786,100786,2012,7,NPS,0,maiz
Chihuahua,33,8,2012,7,D1,25,maiz
Guanajuato,42,42,2012,7,NPS,0,maiz
Guerrero,1450,1450,2012,7,NPS,0,maiz
Hidalgo,23913,23913,2012,7,NPS,0,maiz
Jalisco,739,739,2012,7,NPS,0,maiz
Michoacán de Ocampo,144,144,2012,7,NPS,0,maiz
Nayarit,753,753,2012,7,NPS,0,maiz
Nuevo León,1066,278,2012,7,NPS,788,maiz
Oaxaca,46238,46045,2012,7,NPS,193,maiz
Puebla,20406,18008,2012,7,NPS,2398,maiz
Quintana Roo,3750,3750,2012,7,NPS,0,maiz
San Luis Potosí,10139,9799,2012,7,NPS,340,maiz
Sinaloa,6355,2570,2012,7,NPS,3785,maiz
Sonora,6,6,2012,7,D1,0,maiz
Tabasco,41653,41475,2012,7,NPS,178,maiz
Tamaulipas,1777,1636,2012,7,NPS,141,maiz
Veracruz de Ignacio de la Llave,194283,193022,2012,7,NPS,1261,maiz
Yucatán,211,200,2012,7,NPS,11,maiz
Campeche,5883,5768,2012,8,NPS,115,maiz
Chiapas,100786,100786,2012,8,NPS,0,maiz
Chihuahua,33,8,2012,8,D1,25,maiz
Guanajuato,42,42,2012,8,NPS,0,maiz
Guerrero,1450,1450,2012,8,NPS,0,maiz
Hidalgo,23913,23913,2012,8,NPS,0,maiz
Jalisco,739,739,2012,8,NPS,0,maiz
Michoacán de Ocampo,144,144,2012,8,NPS,0,maiz
Nayarit,753,753,2012,8,NPS,0,maiz
Nuevo León,1066,278,2012,8,D0,788,maiz
Oaxaca,46238,46045,2012,8,NPS,193,maiz
Puebla,20406,20406,2012,8,NPS,0,maiz
Quintana Roo,3750,3750,2012,8,NPS,0,maiz
San Luis Potosí,10139,9799,2012,8,NPS,340,maiz
Sinaloa,4816,1030,2012,8,NPS,3786,maiz
Sonora,6,6,2012,8,D1,0,maiz
Tabasco,41653,41475,2012,8,NPS,178,maiz
Tamaulipas,1777,1719,2012,8,NPS,58,maiz
Veracruz de Ignacio de la Llave,194283,193517,2012,8,NPS,766,maiz
Yucatán,211,200,2012,8,NPS,11,maiz
Campeche,5893,5773,2012,9,NPS,120,maiz
Chiapas,100786,100786,2012,9,NPS,0,maiz
Chihuahua,33,8,2012,9,D1,25,maiz
Guanajuato,42,42,2012,9,NPS,0,maiz
Guerrero,1450,1450,2012,9,NPS,0,maiz
Hidalgo,23913,23913,2012,9,NPS,0,maiz
Jalisco,739,739,2012,9,NPS,0,maiz
Michoacán de Ocampo,144,144,2012,9,NPS,0,maiz
Nayarit,753,753,2012,9,NPS,0,maiz
Nuevo León,1066,278,2012,9,D0,788,maiz
Oaxaca,46238,46045,2012,9,NPS,193,maiz
Puebla,20406,20406,2012,9,NPS,0,maiz
Quintana Roo,3750,3750,2012,9,NPS,0,maiz
San Luis Potosí,10139,9799,2012,9,NPS,340,maiz
Sinaloa,4816,1032,2012,9,NPS,3784,maiz
Sonora,6,6,2012,9,D1,0,maiz
Tabasco,41653,41475,2012,9,NPS,178,maiz
Tamaulipas,1777,1719,2012,9,NPS,58,maiz
Veracruz de Ignacio de la Llave,194283,193518,2012,9,NPS,765,maiz
Yucatán,211,200,2012,9,NPS,11,maiz
Campeche,5893,5773,2012,12,NPS,120,maiz
Chiapas,100786,100786,2012,12,NPS,0,maiz
Chihuahua,33,8,2012,12,NPS,25,maiz
Guanajuato,42,42,2012,12,NPS,0,maiz
Guerrero,1450,1450,2012,12,NPS,0,maiz
Hidalgo,23913,23913,2012,12,NPS,0,maiz
Jalisco,739,739,2012,12,NPS,0,maiz
Michoacán de Ocampo,144,144,2012,12,NPS,0,maiz
Nayarit,753,753,2012,12,NPS,0,maiz
Nuevo León,1066,278,2012,12,D0,788,maiz
Oaxaca,46238,46045,2012,12,NPS,193,maiz
Puebla,20406,20406,2012,12,NPS,0,maiz
Quintana Roo,3750,3750,2012,12,NPS,0,maiz
San Luis Potosí,10139,9799,2012,12,D0,340,maiz
Sinaloa,4816,1032,2012,12,NPS,3784,maiz
Sonora,6,6,2012,12,D1,0,maiz
Tabasco,41653,41475,2012,12,NPS,178,maiz
Tamaulipas,1777,1719,2012,12,NPS,58,maiz
Veracruz de Ignacio de la Llave,194283,193518,2012,12,NPS,765,maiz
Yucatán,211,200,2012,12,NPS,11,maiz
Campeche,6001,222,2013,1,NPS,5779,maiz
Chiapas,93395,6746,2013,1,NPS,86649,maiz
Oaxaca,46736,820,2013,1,NPS,45916,maiz
Quintana Roo,2900,580,2013,1,NPS,2320,maiz
Campeche,6001,548,2013,2,NPS,5453,maiz
Chiapas,96545,12541,2013,2,NPS,84004,maiz
Hidalgo,25657,98,2013,2,NPS,25559,maiz
Oaxaca,46926,5070,2013,2,NPS,41856,maiz
Quintana Roo,3097,800,2013,2,NPS,2297,maiz
Tabasco,37802,110,2013,2,D0,37692,maiz
Veracruz de Ignacio de la Llave,166344,185,2013,2,NPS,166159,maiz
Campeche,6001,834,2013,3,NPS,5167,maiz
Chiapas,96943,20150,2013,3,NPS,76793,maiz
Guerrero,1427,82,2013,3,NPS,1345,maiz
Hidalgo,25697,3427,2013,3,D0,22270,maiz
Jalisco,814,427,2013,3,NPS,387,maiz
Nayarit,1788,405,2013,3,D0,1383,maiz
Oaxaca,46926,16686,2013,3,NPS,30240,maiz
Quintana Roo,3097,2465,2013,3,NPS,632,maiz
San Luis Potosí,10558,272,2013,3,NPS,10286,maiz
Tabasco,38292,7394,2013,3,NPS,30898,maiz
Veracruz de Ignacio de la Llave,183394,3720,2013,3,NPS,179674,maiz
Yucatán,500,500,2013,3,NPS,0,maiz
Campeche,6001,4800,2013,4,D0,1201,maiz
Chiapas,96943,26206,2013,4,D0,70737,maiz
Guerrero,1427,557,2013,4,NPS,870,maiz
Hidalgo,25697,15418,2013,4,D0,10279,maiz
Jalisco,814,677,2013,4,NPS,137,maiz
Michoacán de Ocampo,140,140,2013,4,NPS,0,maiz
Nayarit,1707,616,2013,4,NPS,1091,maiz
Oaxaca,46926,35004,2013,4,NPS,11922,maiz
Quintana Roo,3097,3027,2013,4,NPS,70,maiz
San Luis Potosí,10558,6639,2013,4,D0,3919,maiz
Sinaloa,2108,1090,2013,4,NPS,1018,maiz
Tabasco,38882,21533,2013,4,D0,17349,maiz
Tamaulipas,6370,3745,2013,4,D0,2625,maiz
Veracruz de Ignacio de la Llave,185644,59329,2013,4,NPS,126315,maiz
Yucatán,500,500,2013,4,NPS,0,maiz
Campeche,6001,5922,2013,5,NPS,79,maiz
Chiapas,96943,75780,2013,5,NPS,21163,maiz
Chihuahua,30,30,2013,5,D0,0,maiz
Guerrero,1427,1296,2013,5,NPS,131,maiz
Hidalgo,25697,18954,2013,5,D0,6743,maiz
Jalisco,814,814,2013,5,NPS,0,maiz
Michoacán de Ocampo,140,140,2013,5,NPS,0,maiz
Nayarit,1207,1207,2013,5,D1,0,maiz
Oaxaca,46926,45509,2013,5,NPS,1417,maiz
Quintana Roo,3097,3097,2013,5,D0,0,maiz
San Luis Potosí,10558,10257,2013,5,D0,301,maiz
Sinaloa,1938,1609,2013,5,D0,329,maiz
Tabasco,38882,35981,2013,5,NPS,2901,maiz
Tamaulipas,6370,4902,2013,5,D0,1468,maiz
Veracruz de Ignacio de la Llave,185644,157140,2013,5,NPS,28504,maiz
Yucatán,500,500,2013,5,NPS,0,maiz
Campeche,6001,5922,2013,6,NPS,79,maiz
Chiapas,96943,89812,2013,6,NPS,7131,maiz
Chihuahua,30,30,2013,6,D0,0,maiz
Guerrero,1427,1427,2013,6,NPS,0,maiz
Hidalgo,25701,21816,2013,6,NPS,3885,maiz
Jalisco,814,814,2013,6,NPS,0,maiz
Michoacán de Ocampo,140,140,2013,6,NPS,0,maiz
Nayarit,1207,1207,2013,6,NPS,0,maiz
Nuevo León,354,4,2013,6,NPS,350,maiz
Oaxaca,46926,46926,2013,6,NPS,0,maiz
Puebla,17618,3707,2013,6,NPS,13911,maiz
Quintana Roo,3097,3097,2013,6,NPS,0,maiz
San Luis Potosí,10558,10327,2013,6,D0,231,maiz
Sinaloa,1938,1609,2013,6,D0,329,maiz
Sonora,6,6,2013,6,D0,0,maiz
Tabasco,38882,38116,2013,6,NPS,766,maiz
Tamaulipas,6370,5117,2013,6,D0,1253,maiz
Veracruz de Ignacio de la Llave,185644,170503,2013,6,NPS,15141,maiz
Yucatán,500,500,2013,6,NPS,0,maiz
Campeche,6001,5922,2013,7,NPS,79,maiz
Chiapas,96943,96943,2013,7,NPS,0,maiz
Chihuahua,30,30,2013,7,NPS,0,maiz
Guerrero,1427,1427,2013,7,D0,0,maiz
Hidalgo,25701,25701,2013,7,NPS,0,maiz
Jalisco,819,819,2013,7,D0,0,maiz
Michoacán de Ocampo,140,140,2013,7,NPS,0,maiz
Nayarit,1207,1207,2013,7,D0,0,maiz
Nuevo León,354,4,2013,7,NPS,350,maiz
Oaxaca,46926,46926,2013,7,NPS,0,maiz
Puebla,17618,16244,2013,7,NPS,1374,maiz
Quintana Roo,3097,3097,2013,7,NPS,0,maiz
San Luis Potosí,10558,10327,2013,7,D0,231,maiz
Sinaloa,1938,1609,2013,7,D0,329,maiz
Sonora,6,6,2013,7,D0,0,maiz
Tabasco,38882,38116,2013,7,NPS,766,maiz
Tamaulipas,6370,5117,2013,7,D1,1253,maiz
Veracruz de Ignacio de la Llave,185644,181954,2013,7,NPS,3690,maiz
Yucatán,500,500,2013,7,NPS,0,maiz
Campeche,6001,5922,2013,8,NPS,79,maiz
Chiapas,96943,96943,2013,8,NPS,0,maiz
Chihuahua,30,30,2013,8,NPS,0,maiz
Guerrero,1427,1427,2013,8,D0,0,maiz
Hidalgo,25701,25701,2013,8,NPS,0,maiz
Jalisco,819,819,2013,8,D0,0,maiz
Michoacán de Ocampo,140,140,2013,8,D0,0,maiz
Nayarit,1207,1207,2013,8,D0,0,maiz
Nuevo León,354,4,2013,8,NPS,350,maiz
Oaxaca,46926,46926,2013,8,NPS,0,maiz
Puebla,17618,16776,2013,8,NPS,842,maiz
Quintana Roo,3097,3097,2013,8,NPS,0,maiz
San Luis Potosí,10558,10327,2013,8,D0,231,maiz
Sinaloa,1938,1928,2013,8,D0,10,maiz
Sonora,6,6,2013,8,D0,0,maiz
Tabasco,38882,38116,2013,8,NPS,766,maiz
Tamaulipas,6370,5117,2013,8,NPS,1253,maiz
Veracruz de Ignacio de la Llave,185644,182729,2013,8,NPS,2915,maiz
Yucatán,500,500,2013,8,NPS,0,maiz
Campeche,6001,5932,2013,9,NPS,69,maiz
Chiapas,96943,96943,2013,9,NPS,0,maiz
Chihuahua,30,30,2013,9,NPS,0,maiz
Guerrero,1427,1427,2013,9,NPS,0,maiz
Hidalgo,25701,25701,2013,9,NPS,0,maiz
Jalisco,819,819,2013,9,NPS,0,maiz
Michoacán de Ocampo,140,140,2013,9,NPS,0,maiz
Nayarit,1207,1207,2013,9,D0,0,maiz
Nuevo León,354,4,2013,9,NPS,350,maiz
Oaxaca,46926,46926,2013,9,NPS,0,maiz
Puebla,17618,17391,2013,9,NPS,227,maiz
Quintana Roo,3097,3097,2013,9,NPS,0,maiz
San Luis Potosí,10558,10327,2013,9,NPS,231,maiz
Sinaloa,1938,1928,2013,9,NPS,10,maiz
Sonora,6,6,2013,9,NPS,0,maiz
Tabasco,38882,38116,2013,9,NPS,766,maiz
Tamaulipas,6370,5255,2013,9,NPS,1115,maiz
Veracruz de Ignacio de la Llave,185644,184979,2013,9,NPS,665,maiz
Yucatán,500,500,2013,9,NPS,0,maiz
Campeche,6001,5932,2013,12,NPS,69,maiz
Chiapas,96943,96943,2013,12,NPS,0,maiz
Chihuahua,30,30,2013,12,NPS,0,maiz
Guerrero,1427,1427,2013,12,NPS,0,maiz
Hidalgo,25701,25701,2013,12,NPS,0,maiz
Jalisco,819,819,2013,12,NPS,0,maiz
Michoacán de Ocampo,140,140,2013,12,NPS,0,maiz
Nayarit,1207,1207,2013,12,NPS,0,maiz
Nuevo León,354,4,2013,12,NPS,350,maiz
Oaxaca,46926,46926,2013,12,NPS,0,maiz
Puebla,17618,17391,2013,12,NPS,227,maiz
Quintana Roo,3097,3097,2013,12,NPS,0,maiz
San Luis Potosí,10558,10327,2013,12,NPS,231,maiz
Sinaloa,1938,1928,2013,12,NPS,10,maiz
Sonora,6,6,2013,12,NPS,0,maiz
Tabasco,38882,38116,2013,12,NPS,766,maiz
Tamaulipas,6370,5255,2013,12,NPS,1115,maiz
Veracruz de Ignacio de la Llave,185644,184979,2013,12,NPS,665,maiz
Yucatán,500,500,2013,12,NPS,0,maiz
Oaxaca,47741,71,2014,1,NPS,47670,maiz
Quintana Roo,3980,450,2014,1,NPS,3530,maiz
Sinaloa,1629,80,2014,1,NPS,1549,maiz
Veracruz de Ignacio de la Llave,174642,117,2014,1,NPS,174525,maiz
Chiapas,99206,680,2014,2,NPS,98526,maiz
Oaxaca,47741,4684,2014,2,NPS,43057,maiz
Quintana Roo,4330,2380,2014,2,NPS,1950,maiz
San Luis Potosí,7994,2121,2014,2,NPS,5873,maiz
Sinaloa,1629,80,2014,2,D0,1549,maiz
Tabasco,26586,70,2014,2,NPS,26516,maiz
Veracruz de Ignacio de la Llave,183414,442,2014,2,NPS,182972,maiz
Yucatán,530,300,2014,2,NPS,230,maiz
Chiapas,99699,26449,2014,3,NPS,73250,maiz
Hidalgo,25764,3403,2014,3,NPS,22361,maiz
Jalisco,870,82,2014,3,NPS,788,maiz
Michoacán de Ocampo,170,58,2014,3,NPS,112,maiz
Nayarit,1441,601,2014,3,NPS,840,maiz
Oaxaca,49045,10933,2014,3,NPS,38112,maiz
Quintana Roo,4330,3800,2014,3,NPS,530,maiz
San Luis Potosí,8653,4357,2014,3,NPS,4296,maiz
Sinaloa,1629,80,2014,3,NPS,1549,maiz
Tabasco,31292,3107,2014,3,NPS,28185,maiz
Veracruz de Ignacio de la Llave,184230,2614,2014,3,NPS,181616,maiz
Yucatán,530,500,2014,3,NPS,30,maiz
Campeche,7812,1726,2014,4,NPS,6086,maiz
Chiapas,99699,38854,2014,4,NPS,60845,maiz
Chihuahua,42,26,2014,4,NPS,16,maiz
Hidalgo,25764,9572,2014,4,NPS,16192,maiz
Jalisco,870,431,2014,4,NPS,439,maiz
Michoacán de Ocampo,170,89,2014,4,NPS,81,maiz
Nayarit,1441,1120,2014,4,NPS,321,maiz
Nuevo León,1438,293,2014,4,NPS,1145,maiz
Oaxaca,49045,26742,2014,4,NPS,22303,maiz
Quintana Roo,4330,4330,2014,4,NPS,0,maiz
San Luis Potosí,8653,6688,2014,4,NPS,1965,maiz
Sinaloa,1629,80,2014,4,D0,1549,maiz
Tabasco,32512,14479,2014,4,NPS,18033,maiz
Tamaulipas,6064,3830,2014,4,NPS,2234,maiz
Veracruz de Ignacio de la Llave,184230,44518,2014,4,NPS,139712,maiz
Yucatán,530,500,2014,4,NPS,30,maiz
Campeche,7812,5937,2014,5,NPS,1875,maiz
Chiapas,99699,79067,2014,5,NPS,20632,maiz
Chihuahua,42,29,2014,5,D0,13,maiz
Guerrero,1699,628,2014,5,NPS,1071,maiz
Hidalgo,25764,20064,2014,5,NPS,5700,maiz
Jalisco,870,698,2014,5,NPS,172,maiz
Michoacán de Ocampo,170,89,2014,5,NPS,81,maiz
Nayarit,1441,1308,2014,5,NPS,133,maiz
Nuevo León,1438,343,2014,5,NPS,1095,maiz
Oaxaca,49045,48605,2014,5,NPS,440,maiz
Puebla,18100,286,2014,5,NPS,17814,maiz
Quintana Roo,4330,4330,2014,5,NPS,0,maiz
San Luis Potosí,8653,8004,2014,5,NPS,649,maiz
Sinaloa,1629,368,2014,5,D0,1261,maiz
Tabasco,32572,28500,2014,5,NPS,4072,maiz
Tamaulipas,6064,5043,2014,5,NPS,1021,maiz
Veracruz de Ignacio de la Llave,184230,132584,2014,5,NPS,51646,maiz
Yucatán,530,500,2014,5,NPS,30,maiz
Campeche,7812,7492,2014,6,NPS,320,maiz
Chiapas,99699,98900,2014,6,NPS,799,maiz
Chihuahua,42,29,2014,6,D0,13,maiz
Guerrero,1699,1429,2014,6,NPS,270,maiz
Hidalgo,25764,20784,2014,6,NPS,4980,maiz
Jalisco,870,870,2014,6,NPS,0,maiz
Michoacán de Ocampo,170,134,2014,6,NPS,36,maiz
Nayarit,1441,1308,2014,6,NPS,133,maiz
Nuevo León,1438,1332,2014,6,D0,106,maiz
Oaxaca,49045,49045,2014,6,NPS,0,maiz
Puebla,18100,5209,2014,6,NPS,12891,maiz
Quintana Roo,4330,4330,2014,6,NPS,0,maiz
San Luis Potosí,8653,8653,2014,6,NPS,0,maiz
Sinaloa,1629,894,2014,6,D0,735,maiz
Tabasco,32572,30178,2014,6,NPS,2394,maiz
Tamaulipas,6064,5603,2014,6,NPS,461,maiz
Veracruz de Ignacio de la Llave,184230,166823,2014,6,NPS,17407,maiz
Yucatán,530,500,2014,6,NPS,30,maiz
Campeche,7812,7796,2014,7,NPS,16,maiz
Chiapas,99699,99699,2014,7,NPS,0,maiz
Chihuahua,42,29,2014,7,D0,13,maiz
Guerrero,1699,1699,2014,7,D0,0,maiz
Hidalgo,25764,25764,2014,7,NPS,0,maiz
Jalisco,870,870,2014,7,NPS,0,maiz
Michoacán de Ocampo,170,134,2014,7,NPS,36,maiz
Nayarit,1441,1308,2014,7,NPS,133,maiz
Nuevo León,1438,1332,2014,7,D0,106,maiz
Oaxaca,49045,49045,2014,7,NPS,0,maiz
Puebla,18100,15848,2014,7,NPS,2252,maiz
Quintana Roo,4330,4330,2014,7,D0,0,maiz
San Luis Potosí,8653,8653,2014,7,NPS,0,maiz
Sinaloa,1629,894,2014,7,NPS,735,maiz
Tabasco,32572,30178,2014,7,NPS,2394,maiz
Tamaulipas,6064,5640,2014,7,NPS,424,maiz
Veracruz de Ignacio de la Llave,184230,180459,2014,7,NPS,3771,maiz
Yucatán,530,530,2014,7,NPS,0,maiz
Campeche,7812,7796,2014,8,NPS,16,maiz
Chiapas,99699,99699,2014,8,NPS,0,maiz
Chihuahua,42,29,2014,8,D0,13,maiz
Guerrero,1699,1699,2014,8,D0,0,maiz
Hidalgo,25764,25764,2014,8,NPS,0,maiz
Jalisco,870,870,2014,8,NPS,0,maiz
Michoacán de Ocampo,170,134,2014,8,D0,36,maiz
Nayarit,1441,1308,2014,8,D0,133,maiz
Nuevo León,1438,1438,2014,8,D0,0,maiz
Oaxaca,49045,49045,2014,8,NPS,0,maiz
Puebla,18100,16314,2014,8,NPS,1786,maiz
Quintana Roo,4330,4330,2014,8,D0,0,maiz
San Luis Potosí,8653,8653,2014,8,NPS,0,maiz
Sinaloa,1629,931,2014,8,NPS,698,maiz
Tabasco,32572,30178,2014,8,NPS,2394,maiz
Tamaulipas,6064,5924,2014,8,D0,140,maiz
Veracruz de Ignacio de la Llave,184230,182597,2014,8,NPS,1633,maiz
Yucatán,530,530,2014,8,NPS,0,maiz
Campeche,7812,7796,2014,9,NPS,16,maiz
Chiapas,99699,99699,2014,9,NPS,0,maiz
Chihuahua,42,29,2014,9,NPS,13,maiz
Guerrero,1699,1699,2014,9,D0,0,maiz
Hidalgo,25764,25764,2014,9,NPS,0,maiz
Jalisco,870,870,2014,9,NPS,0,maiz
Michoacán de Ocampo,170,134,2014,9,D0,36,maiz
Nayarit,1441,1308,2014,9,D0,133,maiz
Nuevo León,1438,1438,2014,9,NPS,0,maiz
Oaxaca,49045,49045,2014,9,NPS,0,maiz
Puebla,18100,16584,2014,9,NPS,1516,maiz
Quintana Roo,4330,4330,2014,9,D0,0,maiz
San Luis Potosí,8653,8653,2014,9,NPS,0,maiz
Sinaloa,1629,931,2014,9,NPS,698,maiz
Tabasco,32572,30178,2014,9,D0,2394,maiz
Tamaulipas,6064,5924,2014,9,NPS,140,maiz
Veracruz de Ignacio de la Llave,184230,183790,2014,9,NPS,440,maiz
Yucatán,530,530,2014,9,NPS,0,maiz
Campeche,7812,7796,2014,12,D0,16,maiz
Chiapas,99699,99699,2014,12,NPS,0,maiz
Chihuahua,42,29,2014,12,NPS,13,maiz
Guerrero,1699,1699,2014,12,NPS,0,maiz
Hidalgo,25764,25764,2014,12,NPS,0,maiz
Jalisco,870,870,2014,12,NPS,0,maiz
Michoacán de Ocampo,170,134,2014,12,NPS,36,maiz
Nayarit,1441,1308,2014,12,NPS,133,maiz
Nuevo León,1438,1438,2014,12,NPS,0,maiz
Oaxaca,49045,49045,2014,12,NPS,0,maiz
Puebla,18100,16584,2014,12,NPS,1516,maiz
Quintana Roo,4330,4330,2014,12,NPS,0,maiz
San Luis Potosí,8653,8653,2014,12,NPS,0,maiz
Sinaloa,1629,931,2014,12,NPS,698,maiz
Tabasco,32572,30178,2014,12,NPS,2394,maiz
Tamaulipas,6064,5924,2014,12,NPS,140,maiz
Veracruz de Ignacio de la Llave,184230,183790,2014,12,NPS,440,maiz
Yucatán,530,530,2014,12,NPS,0,maiz
Oaxaca,48511,76,2015,1,NPS,48435,maiz
San Luis Potosí,12176,350,2015,1,NPS,11826,maiz
Michoacán de Ocampo,475,30,2015,2,D0,445,maiz
Oaxaca,48511,4447,2015,2,NPS,44064,maiz
San Luis Potosí,12986,2956,2015,2,NPS,10030,maiz
Tabasco,31125,906,2015,2,NPS,30219,maiz
Veracruz de Ignacio de la Llave,192143,846,2015,2,NPS,191297,maiz
Chiapas,100066,10968,2015,3,NPS,89098,maiz
Michoacán de Ocampo,1777,443,2015,3,NPS,1334,maiz
Oaxaca,48511,14175,2015,3,NPS,34336,maiz
Quintana Roo,5500,470,2015,3,NPS,5030,maiz
San Luis Potosí,12986,7681,2015,3,NPS,5305,maiz
Sinaloa,2811,225,2015,3,NPS,2586,maiz
Tabasco,37903,7945,2015,3,NPS,29958,maiz
Tamaulipas,13811,114,2015,3,NPS,13697,maiz
Veracruz de Ignacio de la Llave,197813,4414,2015,3,NPS,193399,maiz
Yucatán,507,495,2015,3,NPS,12,maiz
Campeche,8308,6271,2015,4,NPS,2037,maiz
Chiapas,100066,24833,2015,4,NPS,75233,maiz
Guerrero,2325,217,2015,4,D0,2108,maiz
Hidalgo,25621,12815,2015,4,NPS,12806,maiz
Jalisco,883,273,2015,4,NPS,610,maiz
Michoacán de Ocampo,1777,538,2015,4,NPS,1239,maiz
Nayarit,1407,22,2015,4,NPS,1385,maiz
Oaxaca,48511,31604,2015,4,NPS,16907,maiz
Quintana Roo,5500,2383,2015,4,NPS,3117,maiz
San Luis Potosí,12986,9187,2015,4,NPS,3799,maiz
Sinaloa,2811,225,2015,4,NPS,2586,maiz
Tabasco,37903,19851,2015,4,NPS,18052,maiz
Tamaulipas,13811,2064,2015,4,NPS,11747,maiz
Veracruz de Ignacio de la Llave,197813,43531,2015,4,NPS,154282,maiz
Yucatán,507,495,2015,4,NPS,12,maiz
Campeche,8308,8210,2015,5,NPS,98,maiz
Chiapas,100066,92096,2015,5,NPS,7970,maiz
Chihuahua,25,25,2015,5,NPS,0,maiz
Guerrero,2325,1531,2015,5,NPS,794,maiz
Hidalgo,25621,19271,2015,5,NPS,6350,maiz
Jalisco,883,724,2015,5,NPS,159,maiz
Michoacán de Ocampo,1777,538,2015,5,NPS,1239,maiz
Nayarit,1407,1023,2015,5,NPS,384,maiz
Oaxaca,48511,47856,2015,5,NPS,655,maiz
Puebla,18426,112,2015,5,NPS,18314,maiz
Quintana Roo,5500,3245,2015,5,D0,2255,maiz
San Luis Potosí,12986,11933,2015,5,NPS,1053,maiz
Sinaloa,2811,1020,2015,5,NPS,1791,maiz
Tabasco,37903,31836,2015,5,NPS,6067,maiz
Tamaulipas,13811,9125,2015,5,NPS,4686,maiz
Veracruz de Ignacio de la Llave,197813,125361,2015,5,NPS,72452,maiz
Yucatán,507,495,2015,5,D0,12,maiz
Campeche,8308,8286,2015,6,NPS,22,maiz
Chiapas,100066,100066,2015,6,NPS,0,maiz
Chihuahua,25,25,2015,6,NPS,0,maiz
Guerrero,2325,2325,2015,6,NPS,0,maiz
Hidalgo,25621,20647,2015,6,NPS,4974,maiz
Jalisco,883,841,2015,6,NPS,42,maiz
Michoacán de Ocampo,1777,538,2015,6,NPS,1239,maiz
Nayarit,1407,1159,2015,6,NPS,248,maiz
Nuevo León,455,50,2015,6,NPS,405,maiz
Oaxaca,48511,48391,2015,6,NPS,120,maiz
Puebla,18426,4723,2015,6,NPS,13703,maiz
Quintana Roo,5500,5300,2015,6,NPS,200,maiz
San Luis Potosí,12986,12619,2015,6,NPS,367,maiz
Sinaloa,2811,2603,2015,6,NPS,208,maiz
Sonora,56,56,2015,6,NPS,0,maiz
Tabasco,37903,36463,2015,6,NPS,1440,maiz
Tamaulipas,13811,10060,2015,6,NPS,3751,maiz
Veracruz de Ignacio de la Llave,197813,185619,2015,6,NPS,12194,maiz
Yucatán,507,495,2015,6,D0,12,maiz
Campeche,8308,8286,2015,7,D0,22,maiz
Chiapas,100066,100066,2015,7,D0,0,maiz
Chihuahua,25,25,2015,7,NPS,0,maiz
Guerrero,2325,2325,2015,7,D0,0,maiz
Hidalgo,25621,25445,2015,7,NPS,176,maiz
Jalisco,883,841,2015,7,NPS,42,maiz
Michoacán de Ocampo,1777,538,2015,7,NPS,1239,maiz
Nayarit,1407,1159,2015,7,D0,248,maiz
Nuevo León,455,385,2015,7,NPS,70,maiz
Oaxaca,48511,48391,2015,7,NPS,120,maiz
Puebla,18426,16268,2015,7,NPS,2158,maiz
Quintana Roo,5500,5500,2015,7,NPS,0,maiz
San Luis Potosí,12986,12891,2015,7,NPS,95,maiz
Sinaloa,2811,2811,2015,7,NPS,0,maiz
Sonora,56,56,2015,7,NPS,0,maiz
Tabasco,37903,37428,2015,7,D0,475,maiz
Tamaulipas,13811,13038,2015,7,NPS,773,maiz
Veracruz de Ignacio de la Llave,197813,195442,2015,7,NPS,2371,maiz
Yucatán,507,495,2015,7,D0,12,maiz
Campeche,8308,8286,2015,8,D0,22,maiz
Chiapas,100066,100066,2015,8,D1,0,maiz
Chihuahua,25,25,2015,8,NPS,0,maiz
Guerrero,2325,2325,2015,8,D0,0,maiz
Hidalgo,25621,25445,2015,8,NPS,176,maiz
Jalisco,883,841,2015,8,NPS,42,maiz
Michoacán de Ocampo,1777,598,2015,8,D0,1179,maiz
Nayarit,1407,1159,2015,8,D0,248,maiz
Nuevo León,455,408,2015,8,NPS,47,maiz
Oaxaca,48511,48391,2015,8,NPS,120,maiz
Puebla,18426,18018,2015,8,NPS,408,maiz
Quintana Roo,5500,5500,2015,8,NPS,0,maiz
San Luis Potosí,12986,12986,2015,8,NPS,0,maiz
Sinaloa,2811,2811,2015,8,NPS,0,maiz
Sonora,56,56,2015,8,NPS,0,maiz
Tabasco,37903,37428,2015,8,D1,475,maiz
Tamaulipas,13811,13706,2015,8,NPS,105,maiz
Veracruz de Ignacio de la Llave,197813,195508,2015,8,D0,2305,maiz
Yucatán,507,495,2015,8,D1,12,maiz
Campeche,8308,8286,2015,9,D0,22,maiz
Chiapas,100066,100066,2015,9,D1,0,maiz
Chihuahua,25,25,2015,9,NPS,0,maiz
Guerrero,2325,2325,2015,9,D0,0,maiz
Hidalgo,25621,25445,2015,9,NPS,176,maiz
Jalisco,883,841,2015,9,D0,42,maiz
Michoacán de Ocampo,1777,598,2015,9,D0,1179,maiz
Nayarit,1407,1159,2015,9,D0,248,maiz
Nuevo León,455,420,2015,9,NPS,35,maiz
Oaxaca,48511,48391,2015,9,NPS,120,maiz
Puebla,18426,18412,2015,9,NPS,14,maiz
Quintana Roo,5500,5500,2015,9,D0,0,maiz
San Luis Potosí,12986,12986,2015,9,NPS,0,maiz
Sinaloa,2811,2811,2015,9,NPS,0,maiz
Sonora,56,56,2015,9,NPS,0,maiz
Tabasco,37903,37428,2015,9,D1,475,maiz
Tamaulipas,13811,13806,2015,9,NPS,5,maiz
Veracruz de Ignacio de la Llave,197813,196385,2015,9,D0,1428,maiz
Yucatán,507,507,2015,9,D1,0,maiz
Campeche,8308,8286,2015,12,NPS,22,maiz
Chiapas,100066,100066,2015,12,NPS,0,maiz
Chihuahua,25,25,2015,12,NPS,0,maiz
Guerrero,2325,2325,2015,12,NPS,0,maiz
Hidalgo,25621,25445,2015,12,NPS,176,maiz
Jalisco,883,841,2015,12,NPS,42,maiz
Michoacán de Ocampo,1777,598,2015,12,D0,1179,maiz
Nayarit,1407,1159,2015,12,NPS,248,maiz
Nuevo León,455,420,2015,12,D0,35,maiz
Oaxaca,48511,48391,2015,12,NPS,120,maiz
Puebla,18426,18412,2015,12,NPS,14,maiz
Quintana Roo,5500,5500,2015,12,NPS,0,maiz
San Luis Potosí,12986,12986,2015,12,NPS,0,maiz
Sinaloa,2811,2811,2015,12,NPS,0,maiz
Sonora,56,56,2015,12,NPS,0,maiz
Tabasco,37903,37428,2015,12,NPS,475,maiz
Tamaulipas,13811,13806,2015,12,NPS,5,maiz
Veracruz de Ignacio de la Llave,197813,196385,2015,12,NPS,1428,maiz
Yucatán,507,507,2015,12,NPS,0,maiz
Oaxaca,47224,84,2016,1,NPS,47140,maiz
San Luis Potosí,10288,2355,2016,1,NPS,7933,maiz
Oaxaca,47224,3481,2016,2,NPS,43743,maiz
Quintana Roo,4835,675,2016,2,NPS,4160,maiz
San Luis Potosí,10941,4095,2016,2,NPS,6846,maiz
Tabasco,27031,340,2016,2,NPS,26691,maiz
Tamaulipas,22802,20,2016,2,NPS,22782,maiz
Veracruz de Ignacio de la Llave,198907,7039,2016,2,D0,191868,maiz
Yucatán,510,342,2016,2,D0,168,maiz
Campeche,8983,1356,2016,3,NPS,7627,maiz
Chiapas,100713,8225,2016,3,NPS,92488,maiz
Guerrero,2433,414,2016,3,D1,2019,maiz
Oaxaca,47224,10196,2016,3,NPS,37028,maiz
Quintana Roo,5235,1985,2016,3,NPS,3250,maiz
San Luis Potosí,12155,7380,2016,3,NPS,4775,maiz
Sinaloa,2607,280,2016,3,NPS,2327,maiz
Tabasco,34070,3648,2016,3,NPS,30422,maiz
Tamaulipas,23835,400,2016,3,NPS,23435,maiz
Veracruz de Ignacio de la Llave,192090,11656,2016,3,D0,180434,maiz
Yucatán,510,342,2016,3,D0,168,maiz
Campeche,8983,7964,2016,4,D0,1019,maiz
Chiapas,100713,26664,2016,4,D0,74049,maiz
Guerrero,2433,594,2016,4,NPS,1839,maiz
Hidalgo,25578,17761,2016,4,D0,7817,maiz
Jalisco,913,155,2016,4,NPS,758,maiz
Nayarit,1105,136,2016,4,NPS,969,maiz
Oaxaca,47224,29618,2016,4,NPS,17606,maiz
Quintana Roo,5235,2215,2016,4,NPS,3020,maiz
San Luis Potosí,12155,8948,2016,4,NPS,3207,maiz
Sinaloa,2607,1797,2016,4,D0,810,maiz
Tabasco,34072,19142,2016,4,D0,14930,maiz
Tamaulipas,23835,5626,2016,4,NPS,18209,maiz
Veracruz de Ignacio de la Llave,192090,43124,2016,4,D0,148966,maiz
Yucatán,510,342,2016,4,D0,168,maiz
Campeche,8983,8843,2016,5,D1,140,maiz
Chiapas,100713,82171,2016,5,NPS,18542,maiz
Chihuahua,26,26,2016,5,D0,0,maiz
Guerrero,2433,1097,2016,5,NPS,1336,maiz
Hidalgo,25578,20304,2016,5,NPS,5274,maiz
Jalisco,913,516,2016,5,D0,397,maiz
Nayarit,1105,880,2016,5,NPS,225,maiz
Nuevo León,772,59,2016,5,NPS,713,maiz
Oaxaca,47224,42504,2016,5,NPS,4720,maiz
Puebla,19028,118,2016,5,NPS,18910,maiz
Quintana Roo,5235,3087,2016,5,NPS,2148,maiz
San Luis Potosí,12155,9905,2016,5,D0,2250,maiz
Sinaloa,2607,2235,2016,5,D0,372,maiz
Tabasco,34072,31172,2016,5,D0,2900,maiz
Tamaulipas,23835,19350,2016,5,NPS,4485,maiz
Veracruz de Ignacio de la Llave,192090,140033,2016,5,D0,52057,maiz
Yucatán,510,342,2016,5,D0,168,maiz
Campeche,8983,8970,2016,6,D1,13,maiz
Chiapas,100713,99523,2016,6,D0,1190,maiz
Chihuahua,26,26,2016,6,D0,0,maiz
Guerrero,2433,2433,2016,6,NPS,0,maiz
Hidalgo,25578,24258,2016,6,NPS,1320,maiz
Jalisco,913,913,2016,6,D0,0,maiz
Nayarit,1105,1086,2016,6,NPS,19,maiz
Nuevo León,772,496,2016,6,NPS,276,maiz
Oaxaca,47224,47224,2016,6,NPS,0,maiz
Puebla,19028,9670,2016,6,NPS,9358,maiz
Quintana Roo,5235,4915,2016,6,D0,320,maiz
San Luis Potosí,12155,12153,2016,6,D0,2,maiz
Sinaloa,2607,2607,2016,6,D0,0,maiz
Tabasco,34072,33616,2016,6,D1,456,maiz
Tamaulipas,23835,19404,2016,6,NPS,4431,maiz
Veracruz de Ignacio de la Llave,192090,167793,2016,6,D1,24297,maiz
Yucatán,510,342,2016,6,D0,168,maiz
Campeche,8983,8970,2016,7,D0,13,maiz
Chiapas,100713,100713,2016,7,D0,0,maiz
Chihuahua,26,26,2016,7,D0,0,maiz
Guerrero,2433,2433,2016,7,D0,0,maiz
Hidalgo,25578,25490,2016,7,NPS,88,maiz
Jalisco,913,913,2016,7,D0,0,maiz
Nayarit,1105,1105,2016,7,D0,0,maiz
Nuevo León,772,586,2016,7,D0,186,maiz
Oaxaca,47224,47224,2016,7,D0,0,maiz
Puebla,19028,16825,2016,7,NPS,2203,maiz
Quintana Roo,5235,5235,2016,7,D0,0,maiz
San Luis Potosí,12155,12153,2016,7,D0,2,maiz
Sinaloa,2607,2607,2016,7,D0,0,maiz
Sonora,12,12,2016,7,D0,0,maiz
Tabasco,34072,33916,2016,7,D1,156,maiz
Tamaulipas,23835,21851,2016,7,NPS,1984,maiz
Veracruz de Ignacio de la Llave,192090,186933,2016,7,D0,5157,maiz
Yucatán,510,342,2016,7,D1,168,maiz
Campeche,8983,8970,2016,8,NPS,13,maiz
Chiapas,100713,100713,2016,8,D0,0,maiz
Chihuahua,26,26,2016,8,NPS,0,maiz
Guerrero,2433,2433,2016,8,D1,0,maiz
Hidalgo,25578,25575,2016,8,NPS,3,maiz
Jalisco,913,913,2016,8,D0,0,maiz
Nayarit,1105,1105,2016,8,D0,0,maiz
Nuevo León,772,609,2016,8,NPS,163,maiz
Oaxaca,47224,47224,2016,8,NPS,0,maiz
Puebla,19028,18305,2016,8,NPS,723,maiz
Quintana Roo,5235,5235,2016,8,D1,0,maiz
San Luis Potosí,12155,12153,2016,8,D1,2,maiz
Sinaloa,2607,2607,2016,8,D0,0,maiz
Sonora,12,12,2016,8,NPS,0,maiz
Tabasco,34072,33916,2016,8,D0,156,maiz
Tamaulipas,23835,22131,2016,8,D0,1704,maiz
Veracruz de Ignacio de la Llave,192090,187922,2016,8,NPS,4168,maiz
Yucatán,510,342,2016,8,D0,168,maiz
Campeche,8983,8970,2016,9,NPS,13,maiz
Chiapas,100713,100713,2016,9,NPS,0,maiz
Chihuahua,26,26,2016,9,NPS,0,maiz
Guerrero,2433,2433,2016,9,NPS,0,maiz
Hidalgo,25578,25575,2016,9,NPS,3,maiz
Jalisco,913,913,2016,9,NPS,0,maiz
Nayarit,1105,1105,2016,9,NPS,0,maiz
Nuevo León,772,622,2016,9,NPS,150,maiz
Oaxaca,47224,47224,2016,9,D0,0,maiz
Puebla,19028,19028,2016,9,NPS,0,maiz
Quintana Roo,5235,5235,2016,9,D1,0,maiz
San Luis Potosí,12155,12153,2016,9,NPS,2,maiz
Sinaloa,2607,2607,2016,9,NPS,0,maiz
Sonora,12,12,2016,9,NPS,0,maiz
Tabasco,34072,33916,2016,9,D1,156,maiz
Tamaulipas,23835,22131,2016,9,D0,1704,maiz
Veracruz de Ignacio de la Llave,192090,188684,2016,9,NPS,3406,maiz
Yucatán,510,342,2016,9,D0,168,maiz
Campeche,8983,8970,2016,12,D1,13,maiz
Chiapas,100713,100713,2016,12,D0,0,maiz
Chihuahua,26,26,2016,12,NPS,0,maiz
Guerrero,2433,2433,2016,12,D1,0,maiz
Hidalgo,25578,25575,2016,12,NPS,3,maiz
Jalisco,913,913,2016,12,NPS,0,maiz
Nayarit,1105,1105,2016,12,NPS,0,maiz
Nuevo León,772,622,2016,12,NPS,150,maiz
Oaxaca,47224,47224,2016,12,D0,0,maiz
Puebla,19028,19028,2016,12,NPS,0,maiz
Quintana Roo,5235,5235,2016,12,D1,0,maiz
San Luis Potosí,12155,12153,2016,12,NPS,2,maiz
Sinaloa,2607,2607,2016,12,D0,0,maiz
Sonora,12,12,2016,12,D0,0,maiz
Tabasco,34072,33916,2016,12,D1,156,maiz
Tamaulipas,23835,22131,2016,12,NPS,1704,maiz
Veracruz de Ignacio de la Llave,192090,188684,2016,12,NPS,3406,maiz
Yucatán,510,342,2016,12,D1,168,maiz
Campeche,10492,2121,2017,2,D0,8371,maiz
Oaxaca,47868,2632,2017,2,D0,45236,maiz
Quintana Roo,3432,260,2017,2,NPS,3172,maiz
San Luis Potosí,9962,2014,2017,2,D0,7948,maiz
Tabasco,31488,997,2017,2,D2,30491,maiz
Veracruz de Ignacio de la Llave,182788,7753,2017,2,NPS,175035,maiz
Yucatán,529,150,2017,2,NPS,379,maiz
Campeche,10492,3251,2017,3,D1,7241,maiz
Chiapas,100784,9304,2017,3,NPS,91480,maiz
Guerrero,2538,93,2017,3,D1,2445,maiz
Oaxaca,47868,10384,2017,3,D0,37484,maiz
Quintana Roo,3815,1130,2017,3,NPS,2685,maiz
San Luis Potosí,11142,5043,2017,3,D0,6099,maiz
Sinaloa,1550,25,2017,3,D0,1525,maiz
Tabasco,33070,4473,2017,3,D2,28597,maiz
Tamaulipas,11336,603,2017,3,NPS,10733,maiz
Veracruz de Ignacio de la Llave,183298,11659,2017,3,NPS,171639,maiz
Yucatán,529,150,2017,3,D1,379,maiz
Campeche,10492,5051,2017,4,D1,5441,maiz
Chiapas,100874,25260,2017,4,NPS,75614,maiz
Guerrero,2538,93,2017,4,D1,2445,maiz
Hidalgo,24111,16322,2017,4,D0,7789,maiz
Nayarit,1828,166,2017,4,NPS,1662,maiz
Oaxaca,47868,29400,2017,4,NPS,18468,maiz
Quintana Roo,3815,1130,2017,4,NPS,2685,maiz
San Luis Potosí,11142,7420,2017,4,D1,3722,maiz
Sinaloa,1690,305,2017,4,D0,1385,maiz
Tabasco,33070,15955,2017,4,D1,17115,maiz
Tamaulipas,11336,6995,2017,4,NPS,4341,maiz
Veracruz de Ignacio de la Llave,184948,46157,2017,4,NPS,138791,maiz
Yucatán,529,150,2017,4,D0,379,maiz
Campeche,10492,9925,2017,5,D0,567,maiz
Chiapas,100874,78720,2017,5,NPS,22154,maiz
Guerrero,2538,2088,2017,5,D0,450,maiz
Hidalgo,24111,18025,2017,5,D0,6086,maiz
Jalisco,898,578,2017,5,D0,320,maiz
Nayarit,1828,1688,2017,5,NPS,140,maiz
Nuevo León,230,65,2017,5,NPS,165,maiz
Oaxaca,47868,46190,2017,5,NPS,1678,maiz
Puebla,18870,117,2017,5,NPS,18753,maiz
Quintana Roo,3815,2205,2017,5,NPS,1610,maiz
San Luis Potosí,11142,10286,2017,5,D0,856,maiz
Sinaloa,1690,1550,2017,5,D0,140,maiz
Tabasco,33070,26819,2017,5,D1,6251,maiz
Tamaulipas,11336,8039,2017,5,NPS,3297,maiz
Veracruz de Ignacio de la Llave,184948,133985,2017,5,NPS,50963,maiz
Yucatán,529,150,2017,5,D0,379,maiz
Campeche,10492,10446,2017,6,D0,46,maiz
Chiapas,100874,97227,2017,6,D0,3647,maiz
Guerrero,2538,2538,2017,6,NPS,0,maiz
Hidalgo,24111,20246,2017,6,D0,3865,maiz
Jalisco,898,828,2017,6,D1,70,maiz
Nayarit,1828,1828,2017,6,D0,0,maiz
Nuevo León,230,200,2017,6,NPS,30,maiz
Oaxaca,47868,47215,2017,6,NPS,653,maiz
Puebla,18870,9467,2017,6,NPS,9403,maiz
Quintana Roo,3815,3125,2017,6,D0,690,maiz
San Luis Potosí,11142,10624,2017,6,D1,518,maiz
Sinaloa,1690,1690,2017,6,D0,0,maiz
Tabasco,33070,29029,2017,6,D0,4041,maiz
Tamaulipas,11336,8039,2017,6,D0,3297,maiz
Veracruz de Ignacio de la Llave,184948,169891,2017,6,D0,15057,maiz
Yucatán,529,150,2017,6,D0,379,maiz
Campeche,10492,10446,2017,7,NPS,46,maiz
Chiapas,100874,98895,2017,7,D0,1979,maiz
Guerrero,2538,2538,2017,7,D0,0,maiz
Hidalgo,24111,24084,2017,7,D0,27,maiz
Jalisco,898,898,2017,7,D1,0,maiz
Nayarit,1828,1828,2017,7,D1,0,maiz
Nuevo León,230,223,2017,7,D0,7,maiz
Oaxaca,47868,47215,2017,7,NPS,653,maiz
Puebla,18870,14045,2017,7,NPS,4825,maiz
Quintana Roo,3815,3815,2017,7,D0,0,maiz
San Luis Potosí,11142,10624,2017,7,D1,518,maiz
Sinaloa,1690,1690,2017,7,D1,0,maiz
Tabasco,33070,29029,2017,7,D0,4041,maiz
Tamaulipas,11336,11216,2017,7,D0,120,maiz
Veracruz de Ignacio de la Llave,184948,176319,2017,7,D0,8629,maiz
Yucatán,529,161,2017,7,NPS,368,maiz
Campeche,10492,10446,2017,8,NPS,46,maiz
Chiapas,100874,100874,2017,8,D0,0,maiz
Guerrero,2538,2538,2017,8,D0,0,maiz
Hidalgo,24111,24111,2017,8,NPS,0,maiz
Jalisco,898,898,2017,8,NPS,0,maiz
Nayarit,1828,1828,2017,8,D1,0,maiz
Nuevo León,230,230,2017,8,D0,0,maiz
Oaxaca,47868,47215,2017,8,NPS,653,maiz
Puebla,18870,18750,2017,8,NPS,120,maiz
Quintana Roo,3815,3815,2017,8,NPS,0,maiz
San Luis Potosí,11142,10624,2017,8,D1,518,maiz
Sinaloa,1690,1690,2017,8,D0,0,maiz
Tabasco,33070,29029,2017,8,D0,4041,maiz
Tamaulipas,11336,11216,2017,8,D0,120,maiz
Veracruz de Ignacio de la Llave,184948,178189,2017,8,NPS,6759,maiz
Yucatán,529,161,2017,8,NPS,368,maiz
Campeche,10492,10446,2017,9,NPS,46,maiz
Chiapas,100874,100874,2017,9,D0,0,maiz
Guerrero,2538,2538,2017,9,NPS,0,maiz
Hidalgo,24111,24111,2017,9,NPS,0,maiz
Jalisco,898,898,2017,9,NPS,0,maiz
Nayarit,1828,1828,2017,9,NPS,0,maiz
Nuevo León,230,230,2017,9,D0,0,maiz
Oaxaca,47868,47215,2017,9,NPS,653,maiz
Puebla,18870,18870,2017,9,NPS,0,maiz
Quintana Roo,3815,3815,2017,9,NPS,0,maiz
San Luis Potosí,11142,10624,2017,9,D0,518,maiz
Sinaloa,1690,1690,2017,9,D0,0,maiz
Tabasco,33070,29029,2017,9,D0,4041,maiz
Tamaulipas,11336,11216,2017,9,D0,120,maiz
Veracruz de Ignacio de la Llave,184948,184758,2017,9,NPS,190,maiz
Yucatán,529,161,2017,9,NPS,368,maiz
Campeche,10492,10446,2017,12,NPS,46,maiz
Chiapas,100874,100874,2017,12,D0,0,maiz
Guerrero,2538,2538,2017,12,NPS,0,maiz
Hidalgo,24111,24111,2017,12,NPS,0,maiz
Jalisco,898,898,2017,12,D0,0,maiz
Nayarit,1828,1828,2017,12,D0,0,maiz
Nuevo León,230,230,2017,12,NPS,0,maiz
Oaxaca,47868,47215,2017,12,NPS,653,maiz
Puebla,18870,18870,2017,12,NPS,0,maiz
Quintana Roo,3815,3815,2017,12,NPS,0,maiz
San Luis Potosí,11142,10624,2017,12,D0,518,maiz
Sinaloa,1690,1690,2017,12,D1,0,maiz
Tabasco,33070,29029,2017,12,D0,4041,maiz
Tamaulipas,11336,11216,2017,12,D0,120,maiz
Veracruz de Ignacio de la Llave,184948,184758,2017,12,NPS,190,maiz
Yucatán,529,161,2017,12,NPS,368,maiz
Campeche,11583,1904,2018,2,NPS,9679,maiz
Guerrero,2534,154,2018,2,D0,2380,maiz
Nayarit,2018,70,2018,2,D0,1948,maiz
Oaxaca,46054,1112,2018,2,NPS,44942,maiz
San Luis Potosí,9335,2387,2018,2,D0,6948,maiz
Sinaloa,1396,60,2018,2,D1,1336,maiz
Tabasco,33825,1887,2018,2,NPS,31938,maiz
Veracruz de Ignacio de la Llave,180698,4300,2018,2,NPS,176398,maiz
Yucatán,150,150,2018,2,NPS,0,maiz
Campeche,11683,3243,2018,3,NPS,8440,maiz
Chiapas,100617,7561,2018,3,D0,93056,maiz
Guerrero,2534,154,2018,3,D0,2380,maiz
Hidalgo,23342,150,2018,3,NPS,23192,maiz
Nayarit,2018,70,2018,3,D0,1948,maiz
Oaxaca,46054,9734,2018,3,NPS,36320,maiz
San Luis Potosí,10610,5127,2018,3,D0,5483,maiz
Sinaloa,1400,1355,2018,3,D2,45,maiz
Tabasco,34783,4611,2018,3,D0,30172,maiz
Tamaulipas,6525,100,2018,3,NPS,6425,maiz
Veracruz de Ignacio de la Llave,182166,9154,2018,3,NPS,173012,maiz
Yucatán,150,150,2018,3,D0,0,maiz
Campeche,11683,7748,2018,4,NPS,3935,maiz
Chiapas,100617,22344,2018,4,NPS,78273,maiz
Guerrero,2534,600,2018,4,D1,1934,maiz
Hidalgo,23342,14188,2018,4,NPS,9154,maiz
Michoacán de Ocampo,220,143,2018,4,D1,77,maiz
Nayarit,2018,392,2018,4,D1,1626,maiz
Oaxaca,46054,30737,2018,4,NPS,15317,maiz
Quintana Roo,3210,564,2018,4,NPS,2646,maiz
San Luis Potosí,10610,6076,2018,4,NPS,4534,maiz
Sinaloa,1400,1400,2018,4,D2,0,maiz
Tabasco,34783,18430,2018,4,D0,16353,maiz
Tamaulipas,6525,2270,2018,4,NPS,4255,maiz
Veracruz de Ignacio de la Llave,182166,52930,2018,4,NPS,129236,maiz
Yucatán,150,150,2018,4,D0,0,maiz
Campeche,11683,11441,2018,5,NPS,242,maiz
Chiapas,100617,76952,2018,5,NPS,23665,maiz
Chihuahua,9,9,2018,5,D0,0,maiz
Guerrero,2534,2388,2018,5,D1,146,maiz
Hidalgo,23342,18444,2018,5,NPS,4898,maiz
Jalisco,915,532,2018,5,D0,383,maiz
Michoacán de Ocampo,220,220,2018,5,D1,0,maiz
Nayarit,2018,1738,2018,5,D1,280,maiz
Nuevo León,790,20,2018,5,NPS,770,maiz
Oaxaca,46054,44866,2018,5,NPS,1188,maiz
Puebla,17999,125,2018,5,NPS,17874,maiz
Quintana Roo,3210,1902,2018,5,NPS,1308,maiz
San Luis Potosí,10610,8951,2018,5,NPS,1659,maiz
Sinaloa,1400,1400,2018,5,D2,0,maiz
Tabasco,34783,28802,2018,5,D0,5981,maiz
Tamaulipas,6525,4134,2018,5,NPS,2391,maiz
Veracruz de Ignacio de la Llave,182166,135945,2018,5,NPS,46221,maiz
Yucatán,150,150,2018,5,NPS,0,maiz
Campeche,11683,11641,2018,6,NPS,42,maiz
Chiapas,100617,99348,2018,6,D0,1269,maiz
Chihuahua,9,9,2018,6,D0,0,maiz
Guerrero,2534,2534,2018,6,NPS,0,maiz
Hidalgo,23342,22722,2018,6,D0,620,maiz
Jalisco,915,915,2018,6,NPS,0,maiz
Michoacán de Ocampo,220,220,2018,6,NPS,0,maiz
Nayarit,2018,1768,2018,6,D0,250,maiz
Nuevo León,790,505,2018,6,NPS,285,maiz
Oaxaca,46054,45951,2018,6,NPS,103,maiz
Puebla,17999,9566,2018,6,NPS,8433,maiz
Quintana Roo,3210,3210,2018,6,NPS,0,maiz
San Luis Potosí,10610,9772,2018,6,D0,838,maiz
Sinaloa,1400,1400,2018,6,D1,0,maiz
Tabasco,34783,32570,2018,6,D0,2213,maiz
Tamaulipas,6525,4312,2018,6,NPS,2213,maiz
Veracruz de Ignacio de la Llave,182166,168386,2018,6,NPS,13780,maiz
Yucatán,150,150,2018,6,NPS,0,maiz
Campeche,11683,11641,2018,7,D0,42,maiz
Chiapas,100617,100617,2018,7,D0,0,maiz
Chihuahua,9,9,2018,7,D0,0,maiz
Guerrero,2534,2534,2018,7,D0,0,maiz
Hidalgo,23342,23331,2018,7,D0,11,maiz
Jalisco,915,915,2018,7,NPS,0,maiz
Michoacán de Ocampo,220,220,2018,7,NPS,0,maiz
Nayarit,2018,1768,2018,7,D0,250,maiz
Nuevo León,790,505,2018,7,NPS,285,maiz
Oaxaca,46054,45951,2018,7,D0,103,maiz
Puebla,17999,15001,2018,7,NPS,2998,maiz
Quintana Roo,3210,3210,2018,7,NPS,0,maiz
San Luis Potosí,10610,10052,2018,7,D0,558,maiz
Sinaloa,1400,1400,2018,7,D1,0,maiz
Tabasco,34783,32570,2018,7,D1,2213,maiz
Tamaulipas,6525,5232,2018,7,NPS,1293,maiz
Veracruz de Ignacio de la Llave,182166,178154,2018,7,D0,4012,maiz
Yucatán,150,150,2018,7,NPS,0,maiz
Campeche,11683,11641,2018,8,D0,42,maiz
Chiapas,100617,100617,2018,8,D1,0,maiz
Chihuahua,9,9,2018,8,D0,0,maiz
Guerrero,2534,2534,2018,8,D0,0,maiz
Hidalgo,23342,23342,2018,8,D0,0,maiz
Jalisco,915,915,2018,8,D0,0,maiz
Michoacán de Ocampo,220,220,2018,8,NPS,0,maiz
Nayarit,2018,1768,2018,8,D0,250,maiz
Nuevo León,790,510,2018,8,D0,280,maiz
Oaxaca,46054,45951,2018,8,D0,103,maiz
Puebla,17999,17999,2018,8,D0,0,maiz
Quintana Roo,3210,3210,2018,8,NPS,0,maiz
San Luis Potosí,10610,10052,2018,8,D1,558,maiz
Sinaloa,1400,1400,2018,8,D1,0,maiz
Tabasco,34783,32570,2018,8,D2,2213,maiz
Tamaulipas,6525,5392,2018,8,D1,1133,maiz
Veracruz de Ignacio de la Llave,182166,182166,2018,8,D1,0,maiz
Yucatán,150,150,2018,8,NPS,0,maiz
Campeche,11683,11641,2018,9,D0,42,maiz
Chiapas,100617,100617,2018,9,D0,0,maiz
Chihuahua,9,9,2018,9,D0,0,maiz
Guerrero,2534,2534,2018,9,D1,0,maiz
Hidalgo,23342,23342,2018,9,D0,0,maiz
Jalisco,915,915,2018,9,D0,0,maiz
Michoacán de Ocampo,220,220,2018,9,NPS,0,maiz
Nayarit,2018,2018,2018,9,D0,0,maiz
Nuevo León,790,510,2018,9,NPS,280,maiz
Oaxaca,46054,45951,2018,9,D0,103,maiz
Puebla,17999,17999,2018,9,D0,0,maiz
Quintana Roo,3210,3210,2018,9,D0,0,maiz
San Luis Potosí,10610,10052,2018,9,NPS,558,maiz
Sinaloa,1400,1400,2018,9,NPS,0,maiz
Tabasco,34783,32570,2018,9,D3,2213,maiz
Tamaulipas,6525,5392,2018,9,NPS,1133,maiz
Veracruz de Ignacio de la Llave,182166,182166,2018,9,D1,0,maiz
Yucatán,150,150,2018,9,NPS,0,maiz
Campeche,11683,11641,2018,12,D0,42,maiz
Chiapas,100617,100617,2018,12,D0,0,maiz
Chihuahua,9,9,2018,12,NPS,0,maiz
Guerrero,2534,2534,2018,12,NPS,0,maiz
Hidalgo,23342,23342,2018,12,D1,0,maiz
Jalisco,915,915,2018,12,NPS,0,maiz
Michoacán de Ocampo,220,220,2018,12,NPS,0,maiz
Nayarit,2018,2018,2018,12,NPS,0,maiz
Nuevo León,790,510,2018,12,NPS,280,maiz
Oaxaca,46054,45951,2018,12,NPS,103,maiz
Puebla,17999,17999,2018,12,NPS,0,maiz
Quintana Roo,3210,3210,2018,12,D1,0,maiz
San Luis Potosí,10610,10052,2018,12,NPS,558,maiz
Sinaloa,1400,1400,2018,12,NPS,0,maiz
Tabasco,34783,32570,2018,12,D2,2213,maiz
Tamaulipas,6525,5392,2018,12,NPS,1133,maiz
Veracruz de Ignacio de la Llave,182166,182166,2018,12,NPS,0,maiz
Yucatán,150,150,2018,12,D0,0,maiz
Campeche,11083,1304,2019,2,D1,9779,maiz
Chiapas,98050,897,2019,2,D0,97153,maiz
Guerrero,2531,277,2019,2,NPS,2254,maiz
Oaxaca,46326,2200,2019,2,NPS,44126,maiz
San Luis Potosí,13560,6570,2019,2,D0,6990,maiz
Tabasco,32535,1113,2019,2,D2,31422,maiz
Veracruz de Ignacio de la Llave,194504,5265,2019,2,D0,189239,maiz
Yucatán,170,100,2019,2,D0,70,maiz
Campeche,11083,3986,2019,3,D1,7097,maiz
Chiapas,98112,7364,2019,3,D1,90748,maiz
Guerrero,2629,277,2019,3,D0,2352,maiz
Hidalgo,21156,139,2019,3,D1,21017,maiz
Oaxaca,46326,8644,2019,3,NPS,37682,maiz
San Luis Potosí,13968,8620,2019,3,D1,5348,maiz
Sinaloa,1499,630,2019,3,D1,869,maiz
Tabasco,35644,4537,2019,3,D1,31107,maiz
Tamaulipas,12426,1221,2019,3,D1,11205,maiz
Veracruz de Ignacio de la Llave,196815,9980,2019,3,D0,186835,maiz
Yucatán,170,130,2019,3,D0,40,maiz
Campeche,11083,9770,2019,4,D1,1313,maiz
Chiapas,98112,21728,2019,4,D1,76384,maiz
Guerrero,2629,761,2019,4,D0,1868,maiz
Hidalgo,22753,14437,2019,4,D1,8316,maiz
Nayarit,1776,414,2019,4,D0,1362,maiz
Oaxaca,46326,26576,2019,4,NPS,19750,maiz
Quintana Roo,2672,1503,2019,4,D0,1169,maiz
San Luis Potosí,13986,11986,2019,4,D1,2000,maiz
Sinaloa,1499,1229,2019,4,D1,270,maiz
Tabasco,35644,19168,2019,4,D2,16476,maiz
Tamaulipas,12426,3064,2019,4,D0,9362,maiz
Veracruz de Ignacio de la Llave,196815,54946,2019,4,D0,141869,maiz
Yucatán,170,130,2019,4,D0,40,maiz
Campeche,11083,10930,2019,5,D1,153,maiz
Chiapas,98112,75817,2019,5,D1,22295,maiz
Chihuahua,20,20,2019,5,NPS,0,maiz
Guerrero,2629,2531,2019,5,D1,98,maiz
Hidalgo,22753,18047,2019,5,D1,4706,maiz
Jalisco,921,507,2019,5,D0,414,maiz
Nayarit,1776,1677,2019,5,D1,99,maiz
Nuevo León,390,30,2019,5,NPS,360,maiz
Oaxaca,46326,44382,2019,5,D0,1944,maiz
Puebla,17409,137,2019,5,D0,17272,maiz
Quintana Roo,2672,2364,2019,5,D0,308,maiz
San Luis Potosí,13986,13034,2019,5,D1,952,maiz
Sinaloa,1499,1331,2019,5,D1,168,maiz
Tabasco,35644,29625,2019,5,D3,6019,maiz
Tamaulipas,12426,9284,2019,5,D0,3142,maiz
Veracruz de Ignacio de la Llave,196971,99233,2019,5,D0,97738,maiz
Yucatán,170,130,2019,5,D0,40,maiz
Campeche,11083,10930,2019,6,NPS,153,maiz
Chiapas,98112,94925,2019,6,D0,3187,maiz
Chihuahua,20,20,2019,6,NPS,0,maiz
Guerrero,2629,2629,2019,6,D1,0,maiz
Hidalgo,22753,22051,2019,6,D0,702,maiz
Jalisco,921,921,2019,6,D0,0,maiz
Nayarit,1776,1756,2019,6,D1,20,maiz
Nuevo León,390,90,2019,6,NPS,300,maiz
Oaxaca,46326,46304,2019,6,NPS,22,maiz
Puebla,17409,8789,2019,6,D0,8620,maiz
Quintana Roo,2672,2672,2019,6,D1,0,maiz
San Luis Potosí,13986,13788,2019,6,D1,198,maiz
Sinaloa,1499,1331,2019,6,D1,168,maiz
Tabasco,35644,33432,2019,6,D3,2212,maiz
Tamaulipas,12426,9304,2019,6,D0,3122,maiz
Veracruz de Ignacio de la Llave,196971,174484,2019,6,D0,22487,maiz
Yucatán,170,130,2019,6,NPS,40,maiz
Campeche,11083,10930,2019,7,NPS,153,maiz
Chiapas,98112,98112,2019,7,D0,0,maiz
Chihuahua,20,20,2019,7,D0,0,maiz
Guerrero,2629,2629,2019,7,D1,0,maiz
Hidalgo,22753,22658,2019,7,D0,95,maiz
Jalisco,921,921,2019,7,D1,0,maiz
Nayarit,1776,1756,2019,7,D2,20,maiz
Nuevo León,390,390,2019,7,D0,0,maiz
Oaxaca,46326,46304,2019,7,D0,22,maiz
Puebla,17409,16323,2019,7,D0,1086,maiz
Quintana Roo,2672,2672,2019,7,D1,0,maiz
San Luis Potosí,13986,13788,2019,7,D2,198,maiz
Sinaloa,1499,1331,2019,7,D1,168,maiz
Tabasco,35644,33432,2019,7,D3,2212,maiz
Tamaulipas,12426,12106,2019,7,D0,320,maiz
Veracruz de Ignacio de la Llave,196971,182860,2019,7,D1,14111,maiz
Yucatán,170,130,2019,7,NPS,40,maiz
Campeche,11083,10930,2019,8,D0,153,maiz
Chiapas,98112,98112,2019,8,D1,0,maiz
Chihuahua,20,20,2019,8,D0,0,maiz
Guerrero,2629,2629,2019,8,D1,0,maiz
Hidalgo,22753,22669,2019,8,D0,84,maiz
Jalisco,921,921,2019,8,D0,0,maiz
Nayarit,1776,1756,2019,8,D2,20,maiz
Nuevo León,390,390,2019,8,D0,0,maiz
Oaxaca,46326,46304,2019,8,D0,22,maiz
Puebla,17409,17356,2019,8,NPS,53,maiz
Quintana Roo,2672,2672,2019,8,D1,0,maiz
San Luis Potosí,13986,13788,2019,8,D3,198,maiz
Sinaloa,1499,1331,2019,8,D1,168,maiz
Tabasco,35644,33432,2019,8,D3,2212,maiz
Tamaulipas,12426,12321,2019,8,D0,105,maiz
Veracruz de Ignacio de la Llave,196971,186711,2019,8,D2,10260,maiz
Yucatán,170,130,2019,8,NPS,40,maiz
Campeche,11083,10930,2019,9,D0,153,maiz
Chiapas,98112,98112,2019,9,D1,0,maiz
Chihuahua,20,20,2019,9,D0,0,maiz
Guerrero,2629,2629,2019,9,D1,0,maiz
Hidalgo,22753,22753,2019,9,D0,0,maiz
Jalisco,921,921,2019,9,D0,0,maiz
Nayarit,1776,1756,2019,9,D1,20,maiz
Nuevo León,390,390,2019,9,NPS,0,maiz
Oaxaca,46326,46304,2019,9,D0,22,maiz
Puebla,17409,17409,2019,9,NPS,0,maiz
Quintana Roo,2672,2672,2019,9,D1,0,maiz
San Luis Potosí,13986,13788,2019,9,D3,198,maiz
Sinaloa,1499,1499,2019,9,D0,0,maiz
Tabasco,35644,33432,2019,9,D3,2212,maiz
Tamaulipas,12426,12321,2019,9,NPS,105,maiz
Veracruz de Ignacio de la Llave,196971,188525,2019,9,D3,8446,maiz
Yucatán,170,130,2019,9,D0,40,maiz
Campeche,11083,10930,2019,12,NPS,153,maiz
Chiapas,98112,98112,2019,12,NPS,0,maiz
Chihuahua,20,20,2019,12,NPS,0,maiz
Guerrero,2629,2629,2019,12,NPS,0,maiz
Hidalgo,22753,22753,2019,12,D0,0,maiz
Jalisco,921,921,2019,12,NPS,0,maiz
Nayarit,1776,1756,2019,12,NPS,20,maiz
Nuevo León,390,390,2019,12,D0,0,maiz
Oaxaca,46326,46304,2019,12,NPS,22,maiz
Puebla,17409,17409,2019,12,NPS,0,maiz
Quintana Roo,2672,2672,2019,12,NPS,0,maiz
San Luis Potosí,13986,13788,2019,12,D1,198,maiz
Sinaloa,1499,1499,2019,12,NPS,0,maiz
Tabasco,35644,33432,2019,12,D1,2212,maiz
Tamaulipas,12426,12321,2019,12,D1,105,maiz
Veracruz de Ignacio de la Llave,196971,188525,2019,12,D1,8446,maiz
Yucatán,170,130,2019,12,NPS,40,maiz
San Luis Potosí,9998,4612,2020,1,D3,5386,maiz
Campeche,11032,1726,2020,2,D0,9306,maiz
Chiapas,99103,983,2020,2,D0,98120,maiz
Guerrero,2812,214,2020,2,NPS,2598,maiz
Oaxaca,46194,2041,2020,2,NPS,44153,maiz
Quintana Roo,2935,448,2020,2,D0,2487,maiz
San Luis Potosí,9998,6860,2020,2,D3,3138,maiz
Tabasco,34174,599,2020,2,D1,33575,maiz
Veracruz de Ignacio de la Llave,188495,5883,2020,2,NPS,182612,maiz
Yucatán,50,15,2020,2,D0,35,maiz
Campeche,11032,3907,2020,3,D1,7125,maiz
Chiapas,100374,7473,2020,3,D0,92901,maiz
Guerrero,2834,365,2020,3,D0,2469,maiz
Hidalgo,20608,136,2020,3,D0,20472,maiz
Oaxaca,46194,7938,2020,3,NPS,38256,maiz
Quintana Roo,2955,658,2020,3,D0,2297,maiz
San Luis Potosí,9998,9559,2020,3,NPS,439,maiz
Sinaloa,5730,921,2020,3,NPS,4809,maiz
Tabasco,38143,5008,2020,3,D1,33135,maiz
Tamaulipas,18842,1522,2020,3,D1,17320,maiz
Veracruz de Ignacio de la Llave,189691,9362,2020,3,D0,180329,maiz
Yucatán,50,50,2020,3,D0,0,maiz
Campeche,11032,6500,2020,4,D1,4532,maiz
Chiapas,100374,22753,2020,4,D0,77621,maiz
Guerrero,2834,1121,2020,4,D0,1713,maiz
Hidalgo,20608,14429,2020,4,D0,6179,maiz
Nayarit,1932,531,2020,4,NPS,1401,maiz
Oaxaca,46194,24341,2020,4,D0,21853,maiz
Quintana Roo,2955,2083,2020,4,D2,872,maiz
San Luis Potosí,9998,9998,2020,4,D0,0,maiz
Sinaloa,5730,951,2020,4,NPS,4779,maiz
Tabasco,38143,20349,2020,4,D1,17794,maiz
Tamaulipas,18842,12540,2020,4,D0,6302,maiz
Veracruz de Ignacio de la Llave,189691,46059,2020,4,D0,143632,maiz
Yucatán,50,50,2020,4,D2,0,maiz
Campeche,11032,10672,2020,5,NPS,360,maiz
Chiapas,100374,79524,2020,5,NPS,20850,maiz
Chihuahua,26,26,2020,5,NPS,0,maiz
Guerrero,2834,2834,2020,5,D1,0,maiz
Hidalgo,20608,16235,2020,5,NPS,4373,maiz
Jalisco,945,463,2020,5,NPS,482,maiz
Nayarit,1932,966,2020,5,NPS,966,maiz
Nuevo León,75,75,2020,5,NPS,0,maiz
Oaxaca,46194,44746,2020,5,NPS,1448,maiz
Puebla,18067,178,2020,5,NPS,17889,maiz
Quintana Roo,2955,2110,2020,5,NPS,845,maiz
San Luis Potosí,9998,9998,2020,5,D0,0,maiz
Sinaloa,5730,1396,2020,5,D0,4334,maiz
Tabasco,38143,32011,2020,5,NPS,6132,maiz
Tamaulipas,18842,17835,2020,5,D0,1007,maiz
Veracruz de Ignacio de la Llave,189691,124182,2020,5,NPS,65509,maiz
Yucatán,50,50,2020,5,NPS,0,maiz
Campeche,11032,11020,2020,6,NPS,12,maiz
Chiapas,100374,96846,2020,6,NPS,3528,maiz
Chihuahua,26,26,2020,6,D0,0,maiz
Guerrero,2834,2834,2020,6,D2,0,maiz
Hidalgo,20608,17918,2020,6,D0,2690,maiz
Jalisco,945,945,2020,6,D0,0,maiz
Nayarit,1932,966,2020,6,D0,966,maiz
Nuevo León,75,75,2020,6,NPS,0,maiz
Oaxaca,46194,45501,2020,6,D0,693,maiz
Puebla,18067,3101,2020,6,D0,14966,maiz
Quintana Roo,2955,2450,2020,6,NPS,505,maiz
San Luis Potosí,9998,9998,2020,6,D0,0,maiz
Sinaloa,5730,5294,2020,6,D0,436,maiz
Tabasco,38143,37402,2020,6,NPS,741,maiz
Tamaulipas,18842,17930,2020,6,NPS,912,maiz
Veracruz de Ignacio de la Llave,189691,125497,2020,6,NPS,64194,maiz
Yucatán,50,50,2020,6,NPS,0,maiz
Campeche,11032,11020,2020,7,NPS,12,maiz
Chiapas,100374,100374,2020,7,NPS,0,maiz
Chihuahua,26,26,2020,7,D0,0,maiz
Guerrero,2834,2834,2020,7,D2,0,maiz
Hidalgo,20608,20608,2020,7,D0,0,maiz
Jalisco,945,945,2020,7,D0,0,maiz
Nayarit,1932,1246,2020,7,D0,686,maiz
Nuevo León,75,75,2020,7,NPS,0,maiz
Oaxaca,46194,45501,2020,7,D0,693,maiz
Puebla,18067,17782,2020,7,D0,285,maiz
Quintana Roo,2955,2450,2020,7,NPS,505,maiz
San Luis Potosí,9998,9998,2020,7,D0,0,maiz
Sinaloa,5730,5423,2020,7,D0,307,maiz
Tabasco,38143,37402,2020,7,NPS,741,maiz
Tamaulipas,18842,18171,2020,7,NPS,671,maiz
Veracruz de Ignacio de la Llave,189691,185683,2020,7,NPS,4008,maiz
Yucatán,50,50,2020,7,NPS,0,maiz
Campeche,11032,11020,2020,8,NPS,12,maiz
Chiapas,100374,100374,2020,8,NPS,0,maiz
Chihuahua,26,26,2020,8,D0,0,maiz
Guerrero,2834,2834,2020,8,D2,0,maiz
Hidalgo,20608,20608,2020,8,D0,0,maiz
Jalisco,945,945,2020,8,D0,0,maiz
Nayarit,1932,1877,2020,8,D0,55,maiz
Nuevo León,75,75,2020,8,NPS,0,maiz
Oaxaca,46194,45501,2020,8,NPS,693,maiz
Puebla,18067,18047,2020,8,NPS,20,maiz
Quintana Roo,2955,2450,2020,8,NPS,505,maiz
San Luis Potosí,9998,9998,2020,8,D1,0,maiz
Sinaloa,5730,5644,2020,8,D1,86,maiz
Tabasco,38143,37402,2020,8,NPS,741,maiz
Tamaulipas,18842,18171,2020,8,NPS,671,maiz
Veracruz de Ignacio de la Llave,189691,189525,2020,8,NPS,166,maiz
Yucatán,50,50,2020,8,NPS,0,maiz
Campeche,11032,11020,2020,9,D0,12,maiz
Chiapas,100374,100374,2020,9,NPS,0,maiz
Chihuahua,26,26,2020,9,D1,0,maiz
Guerrero,2834,2834,2020,9,D2,0,maiz
Hidalgo,20608,20608,2020,9,D0,0,maiz
Jalisco,945,945,2020,9,D0,0,maiz
Nayarit,1932,1927,2020,9,D0,5,maiz
Nuevo León,75,75,2020,9,NPS,0,maiz
Oaxaca,46194,45519,2020,9,NPS,675,maiz
Puebla,18067,18067,2020,9,NPS,0,maiz
Quintana Roo,2955,2450,2020,9,D0,505,maiz
San Luis Potosí,9998,9998,2020,9,D1,0,maiz
Sinaloa,5730,5730,2020,9,D1,0,maiz
Tabasco,38143,37402,2020,9,NPS,741,maiz
Tamaulipas,18842,18201,2020,9,NPS,641,maiz
Veracruz de Ignacio de la Llave,189691,189691,2020,9,D0,0,maiz
Yucatán,50,50,2020,9,NPS,0,maiz
Campeche,11032,11020,2020,12,NPS,12,maiz
Chiapas,100374,100374,2020,12,NPS,0,maiz
Chihuahua,26,26,2020,12,D2,0,maiz
Guerrero,2834,2834,2020,12,D2,0,maiz
Hidalgo,20608,20608,2020,12,D1,0,maiz
Jalisco,945,945,2020,12,D1,0,maiz
Nayarit,1932,1927,2020,12,D1,5,maiz
Nuevo León,75,75,2020,12,D1,0,maiz
Oaxaca,46194,45519,2020,12,NPS,675,maiz
Puebla,18067,18067,2020,12,NPS,0,maiz
Quintana Roo,2955,2450,2020,12,NPS,505,maiz
San Luis Potosí,9998,9998,2020,12,D1,0,maiz
Sinaloa,5730,5730,2020,12,D2,0,maiz
Tabasco,38143,37402,2020,12,NPS,741,maiz
Tamaulipas,18842,18201,2020,12,D1,641,maiz
Veracruz de Ignacio de la Llave,189691,189691,2020,12,D0,0,maiz
Yucatán,50,50,2020,12,NPS,0,maiz
Baja California,632,6,2004,6,D1,626,maiz
Baja California,718,6,2004,7,D1,712,maiz
Baja California,718,6,2004,8,D1,712,maiz
Morelos,23167,9,2004,8,NPS,23158,maiz
Tabasco,56553,142,2004,8,D0,56411,maiz
Baja California,718,6,2004,9,D2,712,maiz
Coahuila de Zaragoza,33483,168,2004,9,NPS,33315,maiz
Chiapas,804807,13864,2004,9,D1,790943,maiz
Hidalgo,195796,4204,2004,9,NPS,191592,maiz
Morelos,23167,9,2004,9,NPS,23158,maiz
Oaxaca,503324,4855,2004,9,D1,498469,maiz
San Luis Potosí,236180,4421,2004,9,NPS,231759,maiz
Tabasco,57310,4769,2004,9,D1,52541,maiz
Veracruz de Ignacio de la Llave,396188,700,2004,9,D0,395488,maiz
Yucatán,157853,45,2004,9,D0,157808,maiz
Coahuila de Zaragoza,16852,33,2004,9,NPS,16819,maiz
Coahuila de Zaragoza,218,33,2004,9,NPS,185,maiz
Aguascalientes,54715,4324,2004,10,NPS,50391,maiz
Baja California,718,6,2004,10,D0,712,maiz
Coahuila de Zaragoza,33483,7734,2004,10,NPS,25749,maiz
Colima,10470,17,2004,10,D0,10453,maiz
Chiapas,804807,73346,2004,10,D1,731461,maiz
Chihuahua,224488,12316,2004,10,NPS,212172,maiz
Ciudad de México,6249,1797,2004,10,NPS,4452,maiz
Durango,166299,29521,2004,10,NPS,136778,maiz
Guanajuato,325776,18258,2004,10,NPS,307518,maiz
Guerrero,452523,6501,2004,10,NPS,446022,maiz
Hidalgo,195796,40486,2004,10,NPS,155310,maiz
Estado de México,487948,1050,2004,10,NPS,486898,maiz
Michoacán de Ocampo,392373,2423,2004,10,NPS,389950,maiz
Morelos,23167,39,2004,10,NPS,23128,maiz
Nayarit,43303,178,2004,10,NPS,43125,maiz
Nuevo León,58265,8200,2004,10,NPS,50065,maiz
Oaxaca,503324,28550,2004,10,D0,474774,maiz
Querétaro de Arteaga,91248,2255,2004,10,NPS,88993,maiz
San Luis Potosí,236180,46389,2004,10,NPS,189791,maiz
Sonora,2333,480,2004,10,NPS,1853,maiz
Tabasco,57310,21811,2004,10,D1,35499,maiz
Tamaulipas,82534,1211,2004,10,NPS,81323,maiz
Tlaxcala,104198,5000,2004,10,NPS,99198,maiz
Veracruz de Ignacio de la Llave,396406,23416,2004,10,D0,372990,maiz
Yucatán,157853,4253,2004,10,NPS,153600,maiz
Zacatecas,296734,42709,2004,10,NPS,254025,maiz
Coahuila de Zaragoza,16861,2001,2004,10,NPS,14860,maiz
Coahuila de Zaragoza,218,163,2004,10,NPS,55,maiz
Durango,16643,1838,2004,10,NPS,14805,maiz
Aguascalientes,47286,43031,2004,11,NPS,4255,maiz
Baja California,718,8,2004,11,D0,710,maiz
Campeche,146384,39126,2004,11,D0,107258,maiz
Coahuila de Zaragoza,33489,17838,2004,11,NPS,15651,maiz
Colima,10470,579,2004,11,D0,9891,maiz
Chiapas,804807,161368,2004,11,D1,643439,maiz
Chihuahua,221952,89328,2004,11,NPS,132624,maiz
Ciudad de México,6249,1797,2004,11,NPS,4452,maiz
Durango,165726,65310,2004,11,NPS,100416,maiz
Guanajuato,325776,134677,2004,11,NPS,191099,maiz
Guerrero,452523,204902,2004,11,NPS,247621,maiz
Hidalgo,195796,150446,2004,11,NPS,45350,maiz
Jalisco,611352,63634,2004,11,NPS,547718,maiz
Estado de México,487948,151392,2004,11,NPS,336556,maiz
Michoacán de Ocampo,393001,59888,2004,11,NPS,333113,maiz
Morelos,23167,3464,2004,11,NPS,19703,maiz
Nayarit,43303,712,2004,11,NPS,42591,maiz
Nuevo León,58265,54723,2004,11,NPS,3542,maiz
Oaxaca,503324,226993,2004,11,D0,276331,maiz
Puebla,502273,82446,2004,11,NPS,419827,maiz
Querétaro de Arteaga,91248,46494,2004,11,NPS,44754,maiz
Quintana Roo,59344,3955,2004,11,D1,55389,maiz
San Luis Potosí,236180,153083,2004,11,NPS,83097,maiz
Sinaloa,78322,10666,2004,11,NPS,67656,maiz
Sonora,2333,491,2004,11,NPS,1842,maiz
Tabasco,57310,41804,2004,11,D1,15506,maiz
Tamaulipas,84780,13082,2004,11,NPS,71698,maiz
Tlaxcala,104198,35089,2004,11,NPS,69109,maiz
Veracruz de Ignacio de la Llave,396406,101879,2004,11,D0,294527,maiz
Yucatán,157853,8670,2004,11,NPS,149183,maiz
Zacatecas,296734,218668,2004,11,NPS,78066,maiz
Coahuila de Zaragoza,16971,10996,2004,11,NPS,5975,maiz
Coahuila de Zaragoza,218,200,2004,11,NPS,18,maiz
Durango,16753,10796,2004,11,NPS,5957,maiz
Aguascalientes,47286,43031,2005,1,NPS,4255,maiz
Baja California,718,8,2005,1,NPS,710,maiz
Campeche,146384,116872,2005,1,D1,29512,maiz
Coahuila de Zaragoza,33489,31458,2005,1,NPS,2031,maiz
Colima,10166,8186,2005,1,D0,1980,maiz
Chiapas,804807,576764,2005,1,D1,228043,maiz
Chihuahua,221942,134690,2005,1,NPS,87252,maiz
Ciudad de México,6249,6227,2005,1,NPS,22,maiz
Durango,165727,155821,2005,1,NPS,9906,maiz
Guanajuato,325776,295683,2005,1,NPS,30093,maiz
Guerrero,452523,398971,2005,1,NPS,53552,maiz
Hidalgo,195796,184200,2005,1,D0,11596,maiz
Jalisco,611058,499563,2005,1,NPS,111495,maiz
Estado de México,487948,471742,2005,1,NPS,16206,maiz
Michoacán de Ocampo,393001,317005,2005,1,NPS,75996,maiz
Morelos,23167,23167,2005,1,NPS,0,maiz
Nayarit,43303,39568,2005,1,D0,3735,maiz
Nuevo León,59425,58679,2005,1,NPS,746,maiz
Oaxaca,503324,418671,2005,1,D0,84653,maiz
Puebla,502273,337950,2005,1,NPS,164323,maiz
Querétaro de Arteaga,91248,78964,2005,1,NPS,12284,maiz
Quintana Roo,63256,18146,2005,1,D1,45110,maiz
San Luis Potosí,236180,191542,2005,1,NPS,44638,maiz
Sinaloa,78322,51840,2005,1,NPS,26482,maiz
Sonora,2432,491,2005,1,NPS,1941,maiz
Tabasco,57310,51732,2005,1,D1,5578,maiz
Tamaulipas,84780,40000,2005,1,D0,44780,maiz
Tlaxcala,104198,102644,2005,1,NPS,1554,maiz
Veracruz de Ignacio de la Llave,396406,290096,2005,1,D1,106310,maiz
Yucatán,157853,69931,2005,1,D0,87922,maiz
Zacatecas,296734,293608,2005,1,NPS,3126,maiz
Coahuila de Zaragoza,16971,13997,2005,1,NPS,2974,maiz
Coahuila de Zaragoza,218,200,2005,1,NPS,18,maiz
Durango,16753,13797,2005,1,NPS,2956,maiz
Aguascalientes,47286,43031,2005,2,NPS,4255,maiz
Baja California,718,8,2005,2,NPS,710,maiz
Campeche,146384,127624,2005,2,D1,18760,maiz
Coahuila de Zaragoza,33489,31711,2005,2,NPS,1778,maiz
Colima,10076,9670,2005,2,D0,406,maiz
Chiapas,804807,749308,2005,2,D1,55499,maiz
Chihuahua,221942,134690,2005,2,NPS,87252,maiz
Ciudad de México,6249,6227,2005,2,NPS,22,maiz
Durango,166919,160697,2005,2,NPS,6222,maiz
Guanajuato,325776,295683,2005,2,NPS,30093,maiz
Guerrero,452523,443266,2005,2,NPS,9257,maiz
Hidalgo,195796,184200,2005,2,NPS,11596,maiz
Jalisco,607603,576279,2005,2,NPS,31324,maiz
Estado de México,487948,480714,2005,2,NPS,7234,maiz
Michoacán de Ocampo,393001,348262,2005,2,NPS,44739,maiz
Morelos,23167,23167,2005,2,NPS,0,maiz
Nayarit,43303,43295,2005,2,NPS,8,maiz
Nuevo León,59223,58533,2005,2,NPS,690,maiz
Oaxaca,503324,434925,2005,2,D0,68399,maiz
Puebla,502273,413741,2005,2,NPS,88532,maiz
Querétaro de Arteaga,91248,78964,2005,2,NPS,12284,maiz
Quintana Roo,63256,18146,2005,2,D1,45110,maiz
San Luis Potosí,236180,191542,2005,2,NPS,44638,maiz
Sinaloa,78322,51840,2005,2,NPS,26482,maiz
Sonora,2432,663,2005,2,NPS,1769,maiz
Tabasco,57310,51732,2005,2,D2,5578,maiz
Tamaulipas,84780,41625,2005,2,NPS,43155,maiz
Tlaxcala,104198,103830,2005,2,NPS,368,maiz
Veracruz de Ignacio de la Llave,396406,317277,2005,2,D1,79129,maiz
Yucatán,157753,137659,2005,2,D0,20094,maiz
Zacatecas,296734,293961,2005,2,NPS,2773,maiz
Coahuila de Zaragoza,16971,13997,2005,2,NPS,2974,maiz
Coahuila de Zaragoza,218,200,2005,2,NPS,18,maiz
Durango,16753,13797,2005,2,NPS,2956,maiz
Baja California,523,4,2005,7,NPS,519,maiz
Baja California,528,347,2005,8,NPS,181,maiz
Quintana Roo,57908,419,2005,8,D0,57489,maiz
Tabasco,41513,662,2005,8,NPS,40851,maiz
Yucatán,171128,89,2005,8,NPS,171039,maiz
Baja California,528,347,2005,9,NPS,181,maiz
Chiapas,734706,40824,2005,9,NPS,693882,maiz
Oaxaca,491833,1464,2005,9,NPS,490369,maiz
Quintana Roo,57908,419,2005,9,NPS,57489,maiz
Tabasco,43113,7769,2005,9,NPS,35344,maiz
Veracruz de Ignacio de la Llave,405574,312,2005,9,NPS,405262,maiz
Yucatán,174282,247,2005,9,NPS,174035,maiz
Aguascalientes,52249,2544,2005,10,NPS,49705,maiz
Baja California,428,428,2005,10,NPS,0,maiz
Coahuila de Zaragoza,25666,5418,2005,10,NPS,20248,maiz
Colima,9468,627,2005,10,D0,8841,maiz
Chiapas,734706,59057,2005,10,NPS,675649,maiz
Chihuahua,167294,4761,2005,10,NPS,162533,maiz
Ciudad de México,6121,231,2005,10,NPS,5890,maiz
Durango,142394,4305,2005,10,NPS,138089,maiz
Guanajuato,271403,100,2005,10,NPS,271303,maiz
Guerrero,452290,52441,2005,10,NPS,399849,maiz
Hidalgo,168024,22070,2005,10,NPS,145954,maiz
Jalisco,586095,358,2005,10,D0,585737,maiz
Estado de México,435669,344,2005,10,D0,435325,maiz
Michoacán de Ocampo,383849,515,2005,10,D0,383334,maiz
Morelos,25100,67,2005,10,D0,25033,maiz
Nayarit,42573,120,2005,10,NPS,42453,maiz
Oaxaca,491833,1464,2005,10,NPS,490369,maiz
Quintana Roo,58691,6987,2005,10,NPS,51704,maiz
San Luis Potosí,209017,16590,2005,10,NPS,192427,maiz
Tabasco,43113,23145,2005,10,D0,19968,maiz
Tamaulipas,69272,1400,2005,10,NPS,67872,maiz
Tlaxcala,96531,150,2005,10,NPS,96381,maiz
Veracruz de Ignacio de la Llave,411264,4966,2005,10,NPS,406298,maiz
Yucatán,174282,5668,2005,10,NPS,168614,maiz
Zacatecas,247390,9381,2005,10,NPS,238009,maiz
Coahuila de Zaragoza,13171,20,2005,10,NPS,13151,maiz
Coahuila de Zaragoza,116,20,2005,10,NPS,96,maiz
Aguascalientes,52249,8770,2005,11,NPS,43479,maiz
Baja California,428,428,2005,11,NPS,0,maiz
Campeche,149780,10241,2005,11,NPS,139539,maiz
Coahuila de Zaragoza,25666,12420,2005,11,NPS,13246,maiz
Colima,8811,2724,2005,11,D0,6087,maiz
Chiapas,734706,132792,2005,11,NPS,601914,maiz
Chihuahua,167254,28103,2005,11,NPS,139151,maiz
Ciudad de México,6121,2655,2005,11,D0,3466,maiz
Durango,142394,32460,2005,11,NPS,109934,maiz
Guanajuato,271403,37112,2005,11,NPS,234291,maiz
Guerrero,452290,165754,2005,11,NPS,286536,maiz
Hidalgo,164200,83876,2005,11,NPS,80324,maiz
Jalisco,587349,49564,2005,11,D0,537785,maiz
Estado de México,435669,110209,2005,11,D0,325460,maiz
Michoacán de Ocampo,391649,58408,2005,11,D0,333241,maiz
Morelos,25100,5517,2005,11,D0,19583,maiz
Nayarit,42573,1708,2005,11,D0,40865,maiz
Nuevo León,55190,49454,2005,11,NPS,5736,maiz
Oaxaca,491887,91280,2005,11,NPS,400607,maiz
Puebla,472394,122142,2005,11,NPS,350252,maiz
Querétaro de Arteaga,82249,3293,2005,11,NPS,78956,maiz
Quintana Roo,58691,7987,2005,11,NPS,50704,maiz
San Luis Potosí,209017,82758,2005,11,NPS,126259,maiz
Sinaloa,35286,2893,2005,11,NPS,32393,maiz
Sonora,3853,299,2005,11,D0,3554,maiz
Tabasco,43468,32122,2005,11,D0,11346,maiz
Tamaulipas,69722,14462,2005,11,NPS,55260,maiz
Tlaxcala,101531,28732,2005,11,D0,72799,maiz
Veracruz de Ignacio de la Llave,409984,72130,2005,11,NPS,337854,maiz
Yucatán,174282,13866,2005,11,NPS,160416,maiz
Zacatecas,247390,44955,2005,11,NPS,202435,maiz
Coahuila de Zaragoza,13171,20,2005,11,NPS,13151,maiz
Coahuila de Zaragoza,116,20,2005,11,NPS,96,maiz
Aguascalientes,39600,17684,2006,1,D0,21916,maiz
Baja California,428,428,2006,1,D0,0,maiz
Campeche,156304,68702,2006,1,NPS,87602,maiz
Coahuila de Zaragoza,25666,17070,2006,1,D0,8596,maiz
Colima,8811,8811,2006,1,D1,0,maiz
Chiapas,734706,552514,2006,1,NPS,182192,maiz
Chihuahua,167274,54640,2006,1,D1,112634,maiz
Ciudad de México,6121,5762,2006,1,D0,359,maiz
Durango,142394,55983,2006,1,D0,86411,maiz
Guanajuato,271403,108503,2006,1,D0,162900,maiz
Guerrero,452290,438810,2006,1,D0,13480,maiz
Hidalgo,164200,147485,2006,1,D0,16715,maiz
Jalisco,584251,474772,2006,1,D1,109479,maiz
Estado de México,435669,350144,2006,1,D0,85525,maiz
Michoacán de Ocampo,394334,307657,2006,1,D1,86677,maiz
Morelos,25100,20685,2006,1,D0,4415,maiz
Nayarit,42573,27598,2006,1,D1,14975,maiz
Nuevo León,54842,54437,2006,1,D0,405,maiz
Oaxaca,491887,353277,2006,1,D0,138610,maiz
Puebla,472394,331917,2006,1,D0,140477,maiz
Querétaro de Arteaga,82249,41220,2006,1,D0,41029,maiz
Quintana Roo,58691,7987,2006,1,NPS,50704,maiz
San Luis Potosí,209017,150768,2006,1,D0,58249,maiz
Sinaloa,35286,23606,2006,1,D1,11680,maiz
Sonora,3909,299,2006,1,D1,3610,maiz
Tabasco,43468,38431,2006,1,NPS,5037,maiz
Tamaulipas,69741,50698,2006,1,D0,19043,maiz
Tlaxcala,101595,95374,2006,1,D0,6221,maiz
Veracruz de Ignacio de la Llave,408911,252414,2006,1,NPS,156497,maiz
Yucatán,174282,64734,2006,1,NPS,109548,maiz
Zacatecas,228400,98092,2006,1,D0,130308,maiz
Coahuila de Zaragoza,13171,1394,2006,1,D0,11777,maiz
Coahuila de Zaragoza,116,62,2006,1,D0,54,maiz
Durango,13055,1332,2006,1,D0,11723,maiz
Aguascalientes,39600,17684,2006,2,D1,21916,maiz
Baja California,428,428,2006,2,D0,0,maiz
Campeche,156304,75470,2006,2,NPS,80834,maiz
Coahuila de Zaragoza,25666,17104,2006,2,D0,8562,maiz
Colima,8811,8811,2006,2,D1,0,maiz
Chiapas,734706,649109,2006,2,NPS,85597,maiz
Chihuahua,167274,54640,2006,2,D2,112634,maiz
Ciudad de México,6121,5762,2006,2,D1,359,maiz
Durango,142394,58968,2006,2,D1,83426,maiz
Guanajuato,271403,108503,2006,2,D1,162900,maiz
Guerrero,452290,438810,2006,2,D0,13480,maiz
Hidalgo,164200,147485,2006,2,D0,16715,maiz
Jalisco,579563,528387,2006,2,D1,51176,maiz
Estado de México,435669,363778,2006,2,D1,71891,maiz
Michoacán de Ocampo,394474,344857,2006,2,D1,49617,maiz
Morelos,25100,21935,2006,2,D1,3165,maiz
Nayarit,42573,39782,2006,2,D1,2791,maiz
Nuevo León,54842,54447,2006,2,D0,395,maiz
Oaxaca,491887,353277,2006,2,D0,138610,maiz
Puebla,472394,342719,2006,2,D0,129675,maiz
Querétaro de Arteaga,82249,42438,2006,2,D1,39811,maiz
Quintana Roo,58691,40145,2006,2,NPS,18546,maiz
San Luis Potosí,209017,151628,2006,2,D0,57389,maiz
Sinaloa,35286,23606,2006,2,D3,11680,maiz
Sonora,3909,345,2006,2,D2,3564,maiz
Tabasco,43468,38431,2006,2,NPS,5037,maiz
Tamaulipas,69741,54938,2006,2,D0,14803,maiz
Tlaxcala,101714,95493,2006,2,D1,6221,maiz
Veracruz de Ignacio de la Llave,410382,331834,2006,2,NPS,78548,maiz
Yucatán,174282,82846,2006,2,NPS,91436,maiz
Zacatecas,228400,98092,2006,2,D1,130308,maiz
Coahuila de Zaragoza,13171,1394,2006,2,D0,11777,maiz
Coahuila de Zaragoza,116,62,2006,2,D0,54,maiz
Durango,13055,1332,2006,2,D1,11723,maiz
Baja California,398,7,2006,7,NPS,391,maiz
Baja California,398,15,2006,8,D0,383,maiz
Chiapas,732399,1399,2006,8,NPS,731000,maiz
Tabasco,45474,1167,2006,8,NPS,44307,maiz
Zacatecas,245707,9754,2006,8,NPS,235953,maiz
Baja California,398,15,2006,9,D0,383,maiz
Coahuila de Zaragoza,23467,14,2006,9,NPS,23453,maiz
Chiapas,733118,4326,2006,9,D0,728792,maiz
Hidalgo,174497,9976,2006,9,NPS,164521,maiz
Michoacán de Ocampo,359840,1053,2006,9,NPS,358787,maiz
Morelos,24404,6,2006,9,NPS,24398,maiz
Quintana Roo,56207,5992,2006,9,NPS,50215,maiz
San Luis Potosí,205736,220,2006,9,NPS,205516,maiz
Tabasco,45717,10947,2006,9,D0,34770,maiz
Veracruz de Ignacio de la Llave,392591,300,2006,9,NPS,392291,maiz
Yucatán,160767,234,2006,9,D0,160533,maiz
Zacatecas,260762,14672,2006,9,NPS,246090,maiz
Coahuila de Zaragoza,13279,14,2006,9,NPS,13265,maiz
Coahuila de Zaragoza,156,14,2006,9,NPS,142,maiz
Aguascalientes,42057,122,2006,10,NPS,41935,maiz
Baja California,398,15,2006,10,D1,383,maiz
Campeche,159928,18,2006,10,NPS,159910,maiz
Coahuila de Zaragoza,23536,1298,2006,10,D2,22238,maiz
Chiapas,733118,43837,2006,10,NPS,689281,maiz
Chihuahua,106111,16708,2006,10,NPS,89403,maiz
Ciudad de México,6297,214,2006,10,NPS,6083,maiz
Durango,160394,26831,2006,10,NPS,133563,maiz
Guanajuato,284791,700,2006,10,NPS,284091,maiz
Guerrero,441518,41311,2006,10,NPS,400207,maiz
Hidalgo,174497,32694,2006,10,NPS,141803,maiz
Estado de México,480497,91,2006,10,NPS,480406,maiz
Michoacán de Ocampo,365480,1321,2006,10,NPS,364159,maiz
Morelos,24404,112,2006,10,NPS,24292,maiz
Oaxaca,481191,17851,2006,10,NPS,463340,maiz
Quintana Roo,56207,11569,2006,10,D1,44638,maiz
San Luis Potosí,208196,39220,2006,10,NPS,168976,maiz
Tabasco,45807,26062,2006,10,D0,19745,maiz
Tlaxcala,99738,5635,2006,10,NPS,94103,maiz
Veracruz de Ignacio de la Llave,390636,42332,2006,10,D0,348304,maiz
Yucatán,160767,2774,2006,10,D0,157993,maiz
Zacatecas,262745,61400,2006,10,NPS,201345,maiz
Coahuila de Zaragoza,13449,1072,2006,10,D2,12377,maiz
Coahuila de Zaragoza,156,14,2006,10,D2,142,maiz
Durango,13293,1058,2006,10,NPS,12235,maiz
Aguascalientes,42057,24795,2006,11,NPS,17262,maiz
Baja California,398,15,2006,11,D2,383,maiz
Campeche,159273,38378,2006,11,NPS,120895,maiz
Coahuila de Zaragoza,23536,15210,2006,11,D0,8326,maiz
Colima,7842,608,2006,11,NPS,7234,maiz
Chiapas,733118,129392,2006,11,D0,603726,maiz
Chihuahua,106111,76356,2006,11,NPS,29755,maiz
Ciudad de México,6297,1518,2006,11,NPS,4779,maiz
Durango,160264,65329,2006,11,NPS,94935,maiz
Guanajuato,284791,89483,2006,11,NPS,195308,maiz
Guerrero,441518,158285,2006,11,NPS,283233,maiz
Hidalgo,174497,138794,2006,11,D1,35703,maiz
Jalisco,576373,21913,2006,11,NPS,554460,maiz
Estado de México,479246,51994,2006,11,NPS,427252,maiz
Michoacán de Ocampo,365480,45067,2006,11,NPS,320413,maiz
Morelos,24404,3717,2006,11,NPS,20687,maiz
Nayarit,35394,2847,2006,11,NPS,32547,maiz
Nuevo León,26438,23414,2006,11,NPS,3024,maiz
Oaxaca,481191,248296,2006,11,NPS,232895,maiz
Puebla,485030,217171,2006,11,NPS,267859,maiz
Querétaro de Arteaga,85010,3825,2006,11,NPS,81185,maiz
Quintana Roo,56207,21976,2006,11,NPS,34231,maiz
San Luis Potosí,208196,100476,2006,11,NPS,107720,maiz
Sonora,1863,729,2006,11,NPS,1134,maiz
Tabasco,45807,31796,2006,11,NPS,14011,maiz
Tamaulipas,72710,4623,2006,11,NPS,68087,maiz
Tlaxcala,99738,63830,2006,11,D1,35908,maiz
Veracruz de Ignacio de la Llave,391016,144698,2006,11,NPS,246318,maiz
Yucatán,160767,11568,2006,11,D0,149199,maiz
Zacatecas,262745,129329,2006,11,NPS,133416,maiz
Coahuila de Zaragoza,13449,5967,2006,11,D0,7482,maiz
Coahuila de Zaragoza,156,134,2006,11,D0,22,maiz
Durango,13293,5833,2006,11,NPS,7460,maiz
Aguascalientes,37727,31610,2007,1,NPS,6117,maiz
Baja California,398,15,2007,1,D2,383,maiz
Campeche,159639,136609,2007,1,NPS,23030,maiz
Coahuila de Zaragoza,23536,15325,2007,1,NPS,8211,maiz
Colima,7842,7269,2007,1,D1,573,maiz
Chiapas,733118,630069,2007,1,NPS,103049,maiz
Chihuahua,106111,98752,2007,1,NPS,7359,maiz
Ciudad de México,6297,6297,2007,1,NPS,0,maiz
Durango,160264,158092,2007,1,NPS,2172,maiz
Guanajuato,284791,222962,2007,1,NPS,61829,maiz
Guerrero,441518,420121,2007,1,NPS,21397,maiz
Hidalgo,174497,167716,2007,1,D1,6781,maiz
Jalisco,568236,518325,2007,1,NPS,49911,maiz
Estado de México,479247,450069,2007,1,NPS,29178,maiz
Michoacán de Ocampo,365479,276006,2007,1,NPS,89473,maiz
Morelos,24404,23873,2007,1,NPS,531,maiz
Nayarit,35394,33104,2007,1,D1,2290,maiz
Nuevo León,26438,25460,2007,1,NPS,978,maiz
Oaxaca,481493,379609,2007,1,NPS,101884,maiz
Puebla,485030,442421,2007,1,NPS,42609,maiz
Querétaro de Arteaga,85010,33572,2007,1,NPS,51438,maiz
Quintana Roo,56207,28162,2007,1,D0,28045,maiz
San Luis Potosí,208196,138961,2007,1,NPS,69235,maiz
Sinaloa,50585,31298,2007,1,D1,19287,maiz
Sonora,1863,882,2007,1,NPS,981,maiz
Tabasco,45807,37646,2007,1,NPS,8161,maiz
Tamaulipas,72777,36039,2007,1,NPS,36738,maiz
Tlaxcala,99738,99314,2007,1,NPS,424,maiz
Veracruz de Ignacio de la Llave,391017,255973,2007,1,NPS,135044,maiz
Yucatán,160767,105888,2007,1,NPS,54879,maiz
Zacatecas,262745,244112,2007,1,NPS,18633,maiz
Coahuila de Zaragoza,13449,11639,2007,1,NPS,1810,maiz
Coahuila de Zaragoza,156,134,2007,1,NPS,22,maiz
Durango,13293,11505,2007,1,NPS,1788,maiz
Aguascalientes,37727,31610,2007,2,NPS,6117,maiz
Baja California,398,15,2007,2,D1,383,maiz
Campeche,163739,157704,2007,2,NPS,6035,maiz
Coahuila de Zaragoza,23536,15325,2007,2,D0,8211,maiz
Colima,7842,7842,2007,2,NPS,0,maiz
Chiapas,733118,707401,2007,2,NPS,25717,maiz
Chihuahua,106111,98754,2007,2,NPS,7357,maiz
Ciudad de México,6297,6297,2007,2,NPS,0,maiz
Durango,160264,158092,2007,2,NPS,2172,maiz
Guanajuato,284791,222962,2007,2,NPS,61829,maiz
Guerrero,441518,435436,2007,2,NPS,6082,maiz
Hidalgo,174497,167716,2007,2,NPS,6781,maiz
Jalisco,568112,538778,2007,2,NPS,29334,maiz
Estado de México,479247,460608,2007,2,NPS,18639,maiz
Michoacán de Ocampo,365479,331935,2007,2,NPS,33544,maiz
Morelos,24404,24133,2007,2,NPS,271,maiz
Nayarit,35394,34534,2007,2,D1,860,maiz
Nuevo León,26438,25938,2007,2,NPS,500,maiz
Oaxaca,481493,379609,2007,2,NPS,101884,maiz
Puebla,485030,448616,2007,2,NPS,36414,maiz
Querétaro de Arteaga,85010,38599,2007,2,NPS,46411,maiz
Quintana Roo,56207,54739,2007,2,D1,1468,maiz
San Luis Potosí,208196,138999,2007,2,NPS,69197,maiz
Sinaloa,50585,31298,2007,2,D0,19287,maiz
Sonora,1863,882,2007,2,NPS,981,maiz
Tabasco,45807,39168,2007,2,NPS,6639,maiz
Tamaulipas,72777,47969,2007,2,NPS,24808,maiz
Tlaxcala,99618,99194,2007,2,D1,424,maiz
Veracruz de Ignacio de la Llave,391018,354907,2007,2,NPS,36111,maiz
Yucatán,160767,145833,2007,2,NPS,14934,maiz
Zacatecas,260745,244112,2007,2,NPS,16633,maiz
Coahuila de Zaragoza,13449,11639,2007,2,D0,1810,maiz
Coahuila de Zaragoza,156,134,2007,2,D0,22,maiz
Durango,13293,11505,2007,2,NPS,1788,maiz
Coahuila de Zaragoza,26670,39,2007,8,NPS,26631,maiz
Chiapas,659534,542,2007,8,NPS,658992,maiz
Michoacán de Ocampo,359346,3600,2007,8,NPS,355746,maiz
Quintana Roo,57848,35,2007,8,NPS,57813,maiz
Tabasco,42330,50,2007,8,D1,42280,maiz
Coahuila de Zaragoza,26704,279,2007,9,NPS,26425,maiz
Chiapas,560948,3756,2007,9,D0,557192,maiz
Durango,174331,1150,2007,9,D0,173181,maiz
Guanajuato,299374,150,2007,9,NPS,299224,maiz
Hidalgo,182652,4048,2007,9,NPS,178604,maiz
Michoacán de Ocampo,376667,12150,2007,9,D0,364517,maiz
Oaxaca,508148,26182,2007,9,NPS,481966,maiz
Quintana Roo,59984,35,2007,9,D1,59949,maiz
Sinaloa,53229,1150,2007,9,NPS,52079,maiz
Tabasco,45958,6025,2007,9,D1,39933,maiz
Tamaulipas,65544,600,2007,9,NPS,64944,maiz
Veracruz de Ignacio de la Llave,368533,486,2007,9,NPS,368047,maiz
Zacatecas,306491,3180,2007,9,NPS,303311,maiz
Coahuila de Zaragoza,16060,1150,2007,9,NPS,14910,maiz
Durango,15893,1150,2007,9,D0,14743,maiz
Aguascalientes,43796,5124,2007,10,NPS,38672,maiz
Coahuila de Zaragoza,26704,785,2007,10,NPS,25919,maiz
Chiapas,560248,40434,2007,10,NPS,519814,maiz
Chihuahua,197867,46219,2007,10,D1,151648,maiz
Ciudad de México,6235,347,2007,10,NPS,5888,maiz
Durango,172299,8906,2007,10,D1,163393,maiz
Guanajuato,299675,2224,2007,10,NPS,297451,maiz
Guerrero,445958,42977,2007,10,NPS,402981,maiz
Hidalgo,182652,32761,2007,10,NPS,149891,maiz
Estado de México,474550,1391,2007,10,NPS,473159,maiz
Michoacán de Ocampo,376667,12917,2007,10,NPS,363750,maiz
Morelos,25894,955,2007,10,NPS,24939,maiz
Nuevo León,51043,15,2007,10,NPS,51028,maiz
Oaxaca,508148,86017,2007,10,NPS,422131,maiz
Puebla,511221,18797,2007,10,NPS,492424,maiz
Querétaro de Arteaga,92781,40,2007,10,NPS,92741,maiz
Quintana Roo,60454,8275,2007,10,D1,52179,maiz
San Luis Potosí,231800,58546,2007,10,NPS,173254,maiz
Sinaloa,55916,1150,2007,10,NPS,54766,maiz
Sonora,3277,148,2007,10,NPS,3129,maiz
Tabasco,46448,9458,2007,10,NPS,36990,maiz
Tamaulipas,67848,2756,2007,10,NPS,65092,maiz
Tlaxcala,108274,16598,2007,10,NPS,91676,maiz
Veracruz de Ignacio de la Llave,372293,20504,2007,10,NPS,351789,maiz
Yucatán,162694,4163,2007,10,NPS,158531,maiz
Zacatecas,306491,20821,2007,10,NPS,285670,maiz
Coahuila de Zaragoza,16060,1494,2007,10,NPS,14566,maiz
Durango,15893,1494,2007,10,D1,14399,maiz
Aguascalientes,43796,10786,2007,11,NPS,33010,maiz
Campeche,156113,2669,2007,11,NPS,153444,maiz
Coahuila de Zaragoza,26704,22560,2007,11,D0,4144,maiz
Colima,11922,5650,2007,11,NPS,6272,maiz
Chiapas,560248,105773,2007,11,NPS,454475,maiz
Chihuahua,197871,149568,2007,11,D0,48303,maiz
Ciudad de México,6235,2460,2007,11,NPS,3775,maiz
Durango,171161,77054,2007,11,D0,94107,maiz
Guanajuato,299675,65227,2007,11,NPS,234448,maiz
Guerrero,443903,189640,2007,11,NPS,254263,maiz
Hidalgo,182652,108147,2007,11,NPS,74505,maiz
Jalisco,590853,152677,2007,11,D2,438176,maiz
Estado de México,476527,154065,2007,11,NPS,322462,maiz
Michoacán de Ocampo,376667,62281,2007,11,NPS,314386,maiz
Morelos,25894,955,2007,11,NPS,24939,maiz
Nayarit,46412,2979,2007,11,D2,43433,maiz
Nuevo León,51043,46215,2007,11,D0,4828,maiz
Oaxaca,508148,247604,2007,11,NPS,260544,maiz
Puebla,516221,267180,2007,11,NPS,249041,maiz
Querétaro de Arteaga,92781,23929,2007,11,NPS,68852,maiz
Quintana Roo,60454,11495,2007,11,D2,48959,maiz
San Luis Potosí,231800,129315,2007,11,NPS,102485,maiz
Sinaloa,57484,2950,2007,11,D0,54534,maiz
Sonora,3382,404,2007,11,NPS,2978,maiz
Tabasco,46528,20847,2007,11,NPS,25681,maiz
Tamaulipas,67848,35953,2007,11,D0,31895,maiz
Tlaxcala,107215,47375,2007,11,NPS,59840,maiz
Veracruz de Ignacio de la Llave,376198,120678,2007,11,NPS,255520,maiz
Yucatán,162694,18303,2007,11,NPS,144391,maiz
Zacatecas,306491,122646,2007,11,NPS,183845,maiz
Coahuila de Zaragoza,16060,6029,2007,11,D0,10031,maiz
Coahuila de Zaragoza,167,104,2007,11,D0,63,maiz
Durango,15893,5925,2007,11,D0,9968,maiz
Aguascalientes,43326,15204,2008,1,D0,28122,maiz
Campeche,156412,51364,2008,1,D1,105048,maiz
Coahuila de Zaragoza,26704,22606,2008,1,D0,4098,maiz
Colima,11922,11922,2008,1,D0,0,maiz
Chiapas,560248,457661,2008,1,NPS,102587,maiz
Chihuahua,197871,168519,2008,1,D0,29352,maiz
Ciudad de México,6235,6085,2008,1,NPS,150,maiz
Durango,170615,133686,2008,1,D1,36929,maiz
Guanajuato,299675,240830,2008,1,D1,58845,maiz
Guerrero,443903,438707,2008,1,NPS,5196,maiz
Hidalgo,182652,154792,2008,1,NPS,27860,maiz
Jalisco,591011,529453,2008,1,D2,61558,maiz
Estado de México,476527,442588,2008,1,NPS,33939,maiz
Michoacán de Ocampo,376757,336867,2008,1,D1,39890,maiz
Morelos,25894,25658,2008,1,NPS,236,maiz
Nayarit,46412,42103,2008,1,D2,4309,maiz
Nuevo León,51043,50513,2008,1,NPS,530,maiz
Oaxaca,508148,434964,2008,1,NPS,73184,maiz
Puebla,516221,416523,2008,1,NPS,99698,maiz
Querétaro de Arteaga,92781,83861,2008,1,NPS,8920,maiz
Quintana Roo,60454,22896,2008,1,D2,37558,maiz
San Luis Potosí,231800,157987,2008,1,NPS,73813,maiz
Sinaloa,61971,38740,2008,1,D1,23231,maiz
Sonora,3382,1884,2008,1,NPS,1498,maiz
Tabasco,46528,21027,2008,1,NPS,25501,maiz
Tamaulipas,67848,58370,2008,1,D0,9478,maiz
Tlaxcala,107788,93123,2008,1,NPS,14665,maiz
Veracruz de Ignacio de la Llave,376117,243019,2008,1,NPS,133098,maiz
Yucatán,162694,106841,2008,1,D2,55853,maiz
Zacatecas,306491,216451,2008,1,NPS,90040,maiz
Coahuila de Zaragoza,16060,6562,2008,1,D0,9498,maiz
Coahuila de Zaragoza,167,104,2008,1,D0,63,maiz
Durango,15893,6458,2008,1,D1,9435,maiz
Aguascalientes,43326,15204,2008,2,NPS,28122,maiz
Campeche,156412,81668,2008,2,D0,74744,maiz
Coahuila de Zaragoza,26704,22606,2008,2,D1,4098,maiz
Colima,11922,11922,2008,2,D0,0,maiz
Chiapas,560248,495708,2008,2,NPS,64540,maiz
Chihuahua,197871,168519,2008,2,D0,29352,maiz
Ciudad de México,6235,6085,2008,2,NPS,150,maiz
Durango,170615,133686,2008,2,D1,36929,maiz
Guanajuato,299675,240890,2008,2,D1,58785,maiz
Guerrero,443903,439272,2008,2,D0,4631,maiz
Hidalgo,182652,154792,2008,2,NPS,27860,maiz
Jalisco,590958,557405,2008,2,D2,33553,maiz
Estado de México,476527,470080,2008,2,NPS,6447,maiz
Michoacán de Ocampo,384674,366890,2008,2,D2,17784,maiz
Morelos,25894,25853,2008,2,D0,41,maiz
Nayarit,46467,45818,2008,2,D2,649,maiz
Nuevo León,51043,50513,2008,2,D0,530,maiz
Oaxaca,508148,472775,2008,2,NPS,35373,maiz
Puebla,516221,437860,2008,2,NPS,78361,maiz
Querétaro de Arteaga,92781,83861,2008,2,NPS,8920,maiz
Quintana Roo,60454,22980,2008,2,D2,37474,maiz
San Luis Potosí,231800,161361,2008,2,NPS,70439,maiz
Sinaloa,61971,40480,2008,2,D1,21491,maiz
Sonora,3382,1884,2008,2,D0,1498,maiz
Tabasco,46528,21588,2008,2,D0,24940,maiz
Tamaulipas,67848,61279,2008,2,NPS,6569,maiz
Tlaxcala,107946,107134,2008,2,NPS,812,maiz
Veracruz de Ignacio de la Llave,370552,283783,2008,2,NPS,86769,maiz
Yucatán,162694,153076,2008,2,NPS,9618,maiz
Zacatecas,306491,217151,2008,2,D1,89340,maiz
Coahuila de Zaragoza,16060,6562,2008,2,D1,9498,maiz
Coahuila de Zaragoza,167,104,2008,2,D1,63,maiz
Durango,15893,6458,2008,2,D1,9435,maiz
Coahuila de Zaragoza,19920,32,2008,8,NPS,19888,maiz
Guanajuato,289780,625,2008,8,D1,289155,maiz
Nayarit,37542,10,2008,8,D1,37532,maiz
Tabasco,49787,2806,2008,8,NPS,46981,maiz
Zacatecas,243642,3475,2008,8,NPS,240167,maiz
Aguascalientes,48773,4100,2008,9,NPS,44673,maiz
Coahuila de Zaragoza,25760,57,2008,9,NPS,25703,maiz
Chiapas,595588,14169,2008,9,NPS,581419,maiz
Guanajuato,290770,625,2008,9,NPS,290145,maiz
Michoacán de Ocampo,371406,2874,2008,9,D1,368532,maiz
Nayarit,38962,46,2008,9,NPS,38916,maiz
Oaxaca,505835,9197,2008,9,NPS,496638,maiz
Puebla,518120,5451,2008,9,NPS,512669,maiz
San Luis Potosí,227610,675,2008,9,NPS,226935,maiz
Tabasco,50019,9805,2008,9,NPS,40214,maiz
Veracruz de Ignacio de la Llave,406408,200,2008,9,D0,406208,maiz
Zacatecas,249430,4825,2008,9,NPS,244605,maiz
Aguascalientes,48773,5028,2008,10,NPS,43745,maiz
Campeche,154738,2915,2008,10,NPS,151823,maiz
Coahuila de Zaragoza,26420,5324,2008,10,NPS,21096,maiz
Chiapas,595588,55885,2008,10,NPS,539703,maiz
Chihuahua,185803,21783,2008,10,NPS,164020,maiz
Durango,171682,10305,2008,10,NPS,161377,maiz
Guanajuato,295084,8785,2008,10,D0,286299,maiz
Guerrero,448960,48024,2008,10,NPS,400936,maiz
Hidalgo,176100,23239,2008,10,NPS,152861,maiz
Jalisco,565710,70,2008,10,NPS,565640,maiz
Estado de México,459139,4164,2008,10,D0,454975,maiz
Michoacán de Ocampo,371406,13786,2008,10,D1,357620,maiz
Nayarit,38962,46,2008,10,NPS,38916,maiz
Nuevo León,7729,50,2008,10,NPS,7679,maiz
Oaxaca,516608,65696,2008,10,NPS,450912,maiz
Puebla,517891,26295,2008,10,NPS,491596,maiz
Quintana Roo,61665,4510,2008,10,NPS,57155,maiz
San Luis Potosí,231998,54930,2008,10,NPS,177068,maiz
Tabasco,50019,30093,2008,10,D0,19926,maiz
Tamaulipas,65447,1220,2008,10,NPS,64227,maiz
Tlaxcala,101722,7175,2008,10,D1,94547,maiz
Veracruz de Ignacio de la Llave,406918,30063,2008,10,NPS,376855,maiz
Yucatán,158788,168,2008,10,NPS,158620,maiz
Zacatecas,249430,42114,2008,10,NPS,207316,maiz
Coahuila de Zaragoza,13980,123,2008,10,NPS,13857,maiz
Aguascalientes,48799,39593,2008,11,NPS,9206,maiz
Campeche,154738,11220,2008,11,D0,143518,maiz
Coahuila de Zaragoza,26420,15033,2008,11,NPS,11387,maiz
Colima,10465,6110,2008,11,D0,4355,maiz
Chiapas,595588,122384,2008,11,NPS,473204,maiz
Chihuahua,185803,102678,2008,11,NPS,83125,maiz
Ciudad de México,6069,2661,2008,11,D1,3408,maiz
Durango,160630,63573,2008,11,NPS,97057,maiz
Guanajuato,295102,59486,2008,11,D0,235616,maiz
Guerrero,448960,228155,2008,11,NPS,220805,maiz
Hidalgo,176100,101159,2008,11,NPS,74941,maiz
Jalisco,566062,87453,2008,11,D0,478609,maiz
Estado de México,457489,153119,2008,11,D1,304370,maiz
Michoacán de Ocampo,371406,47556,2008,11,D1,323850,maiz
Morelos,25401,5801,2008,11,D0,19600,maiz
Nayarit,38962,3875,2008,11,D0,35087,maiz
Nuevo León,7729,4769,2008,11,NPS,2960,maiz
Oaxaca,516608,250943,2008,11,NPS,265665,maiz
Puebla,517891,188043,2008,11,NPS,329848,maiz
Querétaro de Arteaga,89944,23508,2008,11,NPS,66436,maiz
Quintana Roo,61665,5825,2008,11,NPS,55840,maiz
San Luis Potosí,231998,116607,2008,11,NPS,115391,maiz
Sinaloa,62868,15200,2008,11,NPS,47668,maiz
Sonora,2429,457,2008,11,NPS,1972,maiz
Tabasco,50019,34604,2008,11,D0,15415,maiz
Tamaulipas,65507,31214,2008,11,NPS,34293,maiz
Tlaxcala,101722,47486,2008,11,D1,54236,maiz
Veracruz de Ignacio de la Llave,406924,137346,2008,11,NPS,269578,maiz
Yucatán,158788,288,2008,11,D0,158500,maiz
Zacatecas,249430,139834,2008,11,NPS,109596,maiz
Coahuila de Zaragoza,13980,4545,2008,11,NPS,9435,maiz
Coahuila de Zaragoza,123,123,2008,11,NPS,0,maiz
Durango,13857,4422,2008,11,NPS,9435,maiz
Aguascalientes,48110,46495,2009,1,NPS,1615,maiz
Campeche,154753,48239,2009,1,D1,106514,maiz
Coahuila de Zaragoza,26420,15123,2009,1,D0,11297,maiz
Colima,10465,10465,2009,1,D0,0,maiz
Chiapas,595588,488453,2009,1,D0,107135,maiz
Chihuahua,185803,117301,2009,1,NPS,68502,maiz
Ciudad de México,6069,6069,2009,1,D2,0,maiz
Durango,160630,132174,2009,1,NPS,28456,maiz
Guanajuato,295102,242424,2009,1,D0,52678,maiz
Guerrero,448960,440524,2009,1,NPS,8436,maiz
Hidalgo,176100,168161,2009,1,NPS,7939,maiz
Jalisco,566062,518322,2009,1,NPS,47740,maiz
Estado de México,456244,447739,2009,1,D1,8505,maiz
Michoacán de Ocampo,371406,328445,2009,1,D1,42961,maiz
Morelos,25401,19294,2009,1,D0,6107,maiz
Nayarit,38962,35703,2009,1,D0,3259,maiz
Nuevo León,7729,7529,2009,1,NPS,200,maiz
Oaxaca,516614,472268,2009,1,NPS,44346,maiz
Puebla,524692,474980,2009,1,NPS,49712,maiz
Querétaro de Arteaga,89944,80646,2009,1,NPS,9298,maiz
Quintana Roo,61665,6230,2009,1,NPS,55435,maiz
San Luis Potosí,231998,177123,2009,1,NPS,54875,maiz
Sinaloa,62868,44577,2009,1,D0,18291,maiz
Sonora,2435,1760,2009,1,D0,675,maiz
Tabasco,50019,36812,2009,1,D1,13207,maiz
Tamaulipas,65607,60773,2009,1,NPS,4834,maiz
Tlaxcala,101722,90424,2009,1,D1,11298,maiz
Veracruz de Ignacio de la Llave,406924,272762,2009,1,D0,134162,maiz
Yucatán,158788,25885,2009,1,D1,132903,maiz
Zacatecas,249430,233577,2009,1,NPS,15853,maiz
Coahuila de Zaragoza,13980,13130,2009,1,D0,850,maiz
Coahuila de Zaragoza,123,123,2009,1,D0,0,maiz
Durango,13857,13007,2009,1,NPS,850,maiz
Aguascalientes,48110,46495,2009,2,NPS,1615,maiz
Campeche,154853,95794,2009,2,D1,59059,maiz
Coahuila de Zaragoza,26420,15123,2009,2,D0,11297,maiz
Colima,10465,10465,2009,2,D0,0,maiz
Chiapas,595588,554228,2009,2,D0,41360,maiz
Chihuahua,185803,117301,2009,2,NPS,68502,maiz
Ciudad de México,6069,6069,2009,2,D2,0,maiz
Durango,160630,132174,2009,2,NPS,28456,maiz
Guanajuato,295102,255958,2009,2,D0,39144,maiz
Guerrero,450640,442311,2009,2,NPS,8329,maiz
Hidalgo,176100,168161,2009,2,NPS,7939,maiz
Jalisco,566062,536705,2009,2,NPS,29357,maiz
Estado de México,457819,455529,2009,2,D1,2290,maiz
Michoacán de Ocampo,371406,357635,2009,2,D1,13771,maiz
Morelos,25401,19294,2009,2,D0,6107,maiz
Nayarit,38962,36637,2009,2,D0,2325,maiz
Nuevo León,7729,7529,2009,2,NPS,200,maiz
Oaxaca,516614,509496,2009,2,NPS,7118,maiz
Puebla,524692,484879,2009,2,NPS,39813,maiz
Querétaro de Arteaga,89944,88930,2009,2,NPS,1014,maiz
Quintana Roo,61665,6230,2009,2,D0,55435,maiz
San Luis Potosí,231998,177243,2009,2,NPS,54755,maiz
Sinaloa,62868,44580,2009,2,D0,18288,maiz
Sonora,2435,2232,2009,2,D0,203,maiz
Tabasco,50019,36812,2009,2,D1,13207,maiz
Tamaulipas,65607,60773,2009,2,NPS,4834,maiz
Tlaxcala,101722,97524,2009,2,D1,4198,maiz
Veracruz de Ignacio de la Llave,406924,323328,2009,2,D0,83596,maiz
Yucatán,158788,27631,2009,2,D1,131157,maiz
Zacatecas,249430,233577,2009,2,NPS,15853,maiz
Coahuila de Zaragoza,13980,13130,2009,2,D0,850,maiz
Coahuila de Zaragoza,123,123,2009,2,D0,0,maiz
Durango,13857,13007,2009,2,NPS,850,maiz
Veracruz de Ignacio de la Llave,333561,2559,2009,7,D0,331002,maiz
Colima,10243,30,2009,8,D1,10213,maiz
Chiapas,580588,520,2009,8,D1,580068,maiz
Tabasco,46618,1070,2009,8,D2,45548,maiz
Veracruz de Ignacio de la Llave,381546,2559,2009,8,D1,378987,maiz
Coahuila de Zaragoza,22696,303,2009,9,D2,22393,maiz
Colima,10393,30,2009,9,D2,10363,maiz
Chiapas,570588,6030,2009,9,D2,564558,maiz
Hidalgo,170924,2240,2009,9,NPS,168684,maiz
Oaxaca,518320,3000,2009,9,NPS,515320,maiz
Quintana Roo,67038,4950,2009,9,D2,62088,maiz
Tabasco,46618,7486,2009,9,D3,39132,maiz
Veracruz de Ignacio de la Llave,389160,2765,2009,9,NPS,386395,maiz
Coahuila de Zaragoza,22696,3766,2009,10,NPS,18930,maiz
Colima,10393,30,2009,10,D1,10363,maiz
Chiapas,570037,50140,2009,10,D2,519897,maiz
Chihuahua,118128,17636,2009,10,NPS,100492,maiz
Durango,159768,18821,2009,10,NPS,140947,maiz
Guanajuato,276560,3000,2009,10,D1,273560,maiz
Guerrero,442012,57979,2009,10,NPS,384033,maiz
Hidalgo,170924,12956,2009,10,NPS,157968,maiz
Jalisco,563368,195,2009,10,D1,563173,maiz
Estado de México,466484,5305,2009,10,D1,461179,maiz
Michoacán de Ocampo,375720,7409,2009,10,D2,368311,maiz
Morelos,25624,8,2009,10,D1,25616,maiz
Nayarit,42794,1410,2009,10,D1,41384,maiz
Oaxaca,522328,69805,2009,10,NPS,452523,maiz
Puebla,525134,31244,2009,10,NPS,493890,maiz
Quintana Roo,67038,14814,2009,10,D2,52224,maiz
San Luis Potosí,168582,5531,2009,10,NPS,163051,maiz
Sinaloa,57919,950,2009,10,NPS,56969,maiz
Sonora,1990,360,2009,10,NPS,1630,maiz
Tabasco,46744,25378,2009,10,D3,21366,maiz
Veracruz de Ignacio de la Llave,389200,34007,2009,10,NPS,355193,maiz
Yucatán,149733,2673,2009,10,D3,147060,maiz
Zacatecas,248628,27350,2009,10,NPS,221278,maiz
Coahuila de Zaragoza,11754,398,2009,10,NPS,11356,maiz
Campeche,150649,3029,2009,11,D2,147620,maiz
Coahuila de Zaragoza,22696,8254,2009,11,D1,14442,maiz
Colima,10393,7781,2009,11,D1,2612,maiz
Chiapas,570037,150726,2009,11,D2,419311,maiz
Chihuahua,118190,86440,2009,11,NPS,31750,maiz
Ciudad de México,5881,2621,2009,11,D1,3260,maiz
Durango,149917,75324,2009,11,NPS,74593,maiz
Guanajuato,276560,24690,2009,11,D1,251870,maiz
Guerrero,442012,180616,2009,11,NPS,261396,maiz
Hidalgo,170924,76000,2009,11,NPS,94924,maiz
Jalisco,563368,73003,2009,11,D1,490365,maiz
Estado de México,466843,80523,2009,11,D1,386320,maiz
Michoacán de Ocampo,375720,55893,2009,11,D2,319827,maiz
Morelos,25624,15123,2009,11,D0,10501,maiz
Nayarit,42798,8760,2009,11,D1,34038,maiz
Nuevo León,6700,4425,2009,11,NPS,2275,maiz
Oaxaca,522328,218530,2009,11,NPS,303798,maiz
Puebla,525134,97175,2009,11,D0,427959,maiz
Querétaro de Arteaga,90361,6093,2009,11,NPS,84268,maiz
Quintana Roo,67038,19235,2009,11,D0,47803,maiz
San Luis Potosí,168582,21158,2009,11,NPS,147424,maiz
Sinaloa,57919,1900,2009,11,NPS,56019,maiz
Sonora,1990,430,2009,11,D0,1560,maiz
Tabasco,46744,36079,2009,11,D3,10665,maiz
Tamaulipas,52534,4192,2009,11,D0,48342,maiz
Tlaxcala,99205,28990,2009,11,D0,70215,maiz
Veracruz de Ignacio de la Llave,390064,123716,2009,11,NPS,266348,maiz
Yucatán,149733,13621,2009,11,D3,136112,maiz
Zacatecas,248628,48717,2009,11,NPS,199911,maiz
Coahuila de Zaragoza,11754,5507,2009,11,D1,6247,maiz
Aguascalientes,34734,2591,2010,1,NPS,32143,maiz
Campeche,150654,87230,2010,1,D2,63424,maiz
Coahuila de Zaragoza,22696,8410,2010,1,D0,14286,maiz
Colima,10393,9631,2010,1,D1,762,maiz
Chiapas,573517,430083,2010,1,D2,143434,maiz
Chihuahua,118190,113533,2010,1,NPS,4657,maiz
Ciudad de México,5881,5881,2010,1,D0,0,maiz
Durango,149917,138124,2010,1,NPS,11793,maiz
Guanajuato,276560,74548,2010,1,D1,202012,maiz
Guerrero,442012,416335,2010,1,NPS,25677,maiz
Hidalgo,170924,97680,2010,1,NPS,73244,maiz
Jalisco,563368,430163,2010,1,D2,133205,maiz
Estado de México,466843,423642,2010,1,D0,43201,maiz
Michoacán de Ocampo,375780,253302,2010,1,D1,122478,maiz
Morelos,25624,21812,2010,1,D0,3812,maiz
Nayarit,43394,39146,2010,1,NPS,4248,maiz
Nuevo León,6700,4913,2010,1,NPS,1787,maiz
Oaxaca,522328,359954,2010,1,NPS,162374,maiz
Puebla,525134,223404,2010,1,NPS,301730,maiz
Querétaro de Arteaga,90361,51542,2010,1,NPS,38819,maiz
Quintana Roo,67485,42994,2010,1,D0,24491,maiz
San Luis Potosí,168582,36591,2010,1,NPS,131991,maiz
Sinaloa,57919,16780,2010,1,NPS,41139,maiz
Sonora,1994,1715,2010,1,D0,279,maiz
Tabasco,46744,42204,2010,1,D3,4540,maiz
Tamaulipas,52535,15963,2010,1,NPS,36572,maiz
Tlaxcala,99205,97635,2010,1,NPS,1570,maiz
Veracruz de Ignacio de la Llave,390527,290562,2010,1,NPS,99965,maiz
Yucatán,149720,38550,2010,1,D3,111170,maiz
Zacatecas,248628,130244,2010,1,NPS,118384,maiz
Coahuila de Zaragoza,11754,7418,2010,1,D0,4336,maiz
Aguascalientes,34734,2591,2010,2,NPS,32143,maiz
Campeche,150654,127413,2010,2,D2,23241,maiz
Coahuila de Zaragoza,22696,8410,2010,2,NPS,14286,maiz
Colima,10393,9631,2010,2,NPS,762,maiz
Chiapas,574327,546941,2010,2,D3,27386,maiz
Chihuahua,118193,113536,2010,2,NPS,4657,maiz
Ciudad de México,5881,5881,2010,2,D0,0,maiz
Durango,149917,138124,2010,2,NPS,11793,maiz
Guanajuato,276560,74548,2010,2,NPS,202012,maiz
Guerrero,442012,423698,2010,2,NPS,18314,maiz
Hidalgo,170924,97680,2010,2,NPS,73244,maiz
Jalisco,563368,484204,2010,2,NPS,79164,maiz
Estado de México,466843,440947,2010,2,NPS,25896,maiz
Michoacán de Ocampo,375780,269348,2010,2,NPS,106432,maiz
Morelos,25624,25216,2010,2,D0,408,maiz
Nayarit,43394,40148,2010,2,NPS,3246,maiz
Nuevo León,6700,6250,2010,2,NPS,450,maiz
Oaxaca,522328,382700,2010,2,NPS,139628,maiz
Puebla,525134,231979,2010,2,NPS,293155,maiz
Querétaro de Arteaga,90361,53993,2010,2,NPS,36368,maiz
Quintana Roo,67485,64373,2010,2,D1,3112,maiz
San Luis Potosí,168582,38659,2010,2,NPS,129923,maiz
Sinaloa,57919,16947,2010,2,NPS,40972,maiz
Sonora,1994,1715,2010,2,NPS,279,maiz
Tabasco,46744,42776,2010,2,D3,3968,maiz
Tamaulipas,52535,18737,2010,2,NPS,33798,maiz
Tlaxcala,99205,99205,2010,2,NPS,0,maiz
Veracruz de Ignacio de la Llave,390527,330478,2010,2,NPS,60049,maiz
Yucatán,149733,80590,2010,2,D3,69143,maiz
Zacatecas,248628,132092,2010,2,NPS,116536,maiz
Coahuila de Zaragoza,11754,7418,2010,2,NPS,4336,maiz
Chiapas,542429,930,2010,7,NPS,541499,maiz
Coahuila de Zaragoza,25810,123,2010,8,NPS,25687,maiz
Chiapas,567483,1695,2010,8,NPS,565788,maiz
Tabasco,41715,3205,2010,8,NPS,38510,maiz
Coahuila de Zaragoza,26952,393,2010,9,NPS,26559,maiz
Chiapas,580555,16340,2010,9,NPS,564215,maiz
Hidalgo,170398,6624,2010,9,NPS,163774,maiz
Jalisco,563339,126,2010,9,NPS,563213,maiz
Oaxaca,515613,1955,2010,9,NPS,513658,maiz
Puebla,516522,5250,2010,9,NPS,511272,maiz
Quintana Roo,64580,447,2010,9,NPS,64133,maiz
Tabasco,47068,6445,2010,9,NPS,40623,maiz
Veracruz de Ignacio de la Llave,384804,3999,2010,9,NPS,380805,maiz
Zacatecas,241902,664,2010,9,NPS,241238,maiz
Campeche,147472,1259,2010,10,NPS,146213,maiz
Coahuila de Zaragoza,27620,13633,2010,10,NPS,13987,maiz
Chiapas,587615,76079,2010,10,NPS,511536,maiz
Chihuahua,156779,39361,2010,10,D0,117418,maiz
Durango,160948,7291,2010,10,NPS,153657,maiz
Guanajuato,283843,4318,2010,10,NPS,279525,maiz
Guerrero,442356,59123,2010,10,NPS,383233,maiz
Hidalgo,170398,17100,2010,10,NPS,153298,maiz
Jalisco,564251,51055,2010,10,NPS,513196,maiz
Estado de México,462362,200,2010,10,NPS,462162,maiz
Michoacán de Ocampo,376866,23812,2010,10,NPS,353054,maiz
Nayarit,36373,137,2010,10,NPS,36236,maiz
Nuevo León,3613,25,2010,10,NPS,3588,maiz
Oaxaca,515613,46496,2010,10,NPS,469117,maiz
Puebla,516522,34813,2010,10,NPS,481709,maiz
Quintana Roo,64580,12872,2010,10,D0,51708,maiz
San Luis Potosí,236525,31050,2010,10,NPS,205475,maiz
Tabasco,47068,13968,2010,10,NPS,33100,maiz
Tamaulipas,54667,16503,2010,10,NPS,38164,maiz
Tlaxcala,105767,10252,2010,10,NPS,95515,maiz
Veracruz de Ignacio de la Llave,385003,53714,2010,10,NPS,331289,maiz
Yucatán,144249,15695,2010,10,NPS,128554,maiz
Zacatecas,241902,10326,2010,10,NPS,231576,maiz
Coahuila de Zaragoza,12047,74,2010,10,NPS,11973,maiz
Aguascalientes,44774,12811,2010,11,NPS,31963,maiz
Baja California,57,57,2010,11,NPS,0,maiz
Campeche,147472,19508,2010,11,NPS,127964,maiz
Coahuila de Zaragoza,28528,22944,2010,11,D2,5584,maiz
Colima,9294,4212,2010,11,D0,5082,maiz
Chiapas,587615,178185,2010,11,NPS,409430,maiz
Chihuahua,156779,147076,2010,11,NPS,9703,maiz
Ciudad de México,5647,2607,2010,11,NPS,3040,maiz
Durango,160581,78612,2010,11,NPS,81969,maiz
Guanajuato,283843,68938,2010,11,NPS,214905,maiz
Guerrero,442364,213548,2010,11,NPS,228816,maiz
Hidalgo,170478,117391,2010,11,NPS,53087,maiz
Jalisco,564251,134736,2010,11,NPS,429515,maiz
Estado de México,462362,125628,2010,11,NPS,336734,maiz
Michoacán de Ocampo,376866,87871,2010,11,NPS,288995,maiz
Morelos,26709,14439,2010,11,NPS,12270,maiz
Nayarit,36453,6249,2010,11,NPS,30204,maiz
Nuevo León,17617,15628,2010,11,NPS,1989,maiz
Oaxaca,515613,263269,2010,11,NPS,252344,maiz
Puebla,516522,196098,2010,11,NPS,320424,maiz
Querétaro de Arteaga,93202,17091,2010,11,NPS,76111,maiz
Quintana Roo,64580,30864,2010,11,NPS,33716,maiz
San Luis Potosí,236525,85318,2010,11,NPS,151207,maiz
Sinaloa,34196,18464,2010,11,D0,15732,maiz
Sonora,4119,8,2010,11,NPS,4111,maiz
Tabasco,48133,24249,2010,11,NPS,23884,maiz
Tamaulipas,54669,25148,2010,11,NPS,29521,maiz
Tlaxcala,103886,33971,2010,11,NPS,69915,maiz
Veracruz de Ignacio de la Llave,385125,166823,2010,11,NPS,218302,maiz
Yucatán,144249,32665,2010,11,D0,111584,maiz
Zacatecas,241902,104172,2010,11,NPS,137730,maiz
Coahuila de Zaragoza,12047,3133,2010,11,D2,8914,maiz
Aguascalientes,39361,12833,2011,1,NPS,26528,maiz
Baja California,57,57,2011,1,NPS,0,maiz
Campeche,148460,126244,2011,1,NPS,22216,maiz
Coahuila de Zaragoza,28528,28038,2011,1,D0,490,maiz
Colima,9294,9293,2011,1,D0,1,maiz
Chiapas,587617,487768,2011,1,NPS,99849,maiz
Chihuahua,156779,152678,2011,1,D0,4101,maiz
Ciudad de México,5647,5497,2011,1,NPS,150,maiz
Durango,160581,142639,2011,1,NPS,17942,maiz
Guanajuato,283843,179815,2011,1,D0,104028,maiz
Guerrero,442364,400144,2011,1,NPS,42220,maiz
Hidalgo,170478,137246,2011,1,NPS,33232,maiz
Jalisco,564251,488755,2011,1,D0,75496,maiz
Estado de México,462362,413512,2011,1,NPS,48850,maiz
Michoacán de Ocampo,376866,318123,2011,1,D0,58743,maiz
Morelos,26709,24983,2011,1,NPS,1726,maiz
Nayarit,36453,29954,2011,1,D0,6499,maiz
Nuevo León,21801,20791,2011,1,NPS,1010,maiz
Oaxaca,515613,433193,2011,1,NPS,82420,maiz
Puebla,516522,461362,2011,1,NPS,55160,maiz
Querétaro de Arteaga,93922,75851,2011,1,NPS,18071,maiz
Quintana Roo,64580,53790,2011,1,NPS,10790,maiz
San Luis Potosí,236525,127902,2011,1,NPS,108623,maiz
Sinaloa,34246,26680,2011,1,D0,7566,maiz
Sonora,4119,290,2011,1,D0,3829,maiz
Tabasco,48133,31602,2011,1,NPS,16531,maiz
Tamaulipas,54669,42187,2011,1,NPS,12482,maiz
Tlaxcala,103886,103359,2011,1,NPS,527,maiz
Veracruz de Ignacio de la Llave,385125,279265,2011,1,NPS,105860,maiz
Yucatán,144249,118360,2011,1,NPS,25889,maiz
Zacatecas,241902,147881,2011,1,NPS,94021,maiz
Coahuila de Zaragoza,12047,4406,2011,1,D0,7641,maiz
Aguascalientes,39361,12833,2011,2,NPS,26528,maiz
Baja California,57,57,2011,2,NPS,0,maiz
Campeche,148460,137180,2011,2,D0,11280,maiz
Coahuila de Zaragoza,28528,28038,2011,2,NPS,490,maiz
Colima,9294,9293,2011,2,NPS,1,maiz
Chiapas,587617,540930,2011,2,NPS,46687,maiz
Chihuahua,156779,152678,2011,2,D0,4101,maiz
Ciudad de México,5647,5497,2011,2,NPS,150,maiz
Durango,160581,143185,2011,2,NPS,17396,maiz
Guanajuato,283843,179815,2011,2,NPS,104028,maiz
Guerrero,442364,430456,2011,2,NPS,11908,maiz
Hidalgo,170478,137246,2011,2,NPS,33232,maiz
Jalisco,564251,523624,2011,2,D0,40627,maiz
Estado de México,462362,445291,2011,2,NPS,17071,maiz
Michoacán de Ocampo,376866,357062,2011,2,D0,19804,maiz
Morelos,26709,26709,2011,2,NPS,0,maiz
Nayarit,36453,33725,2011,2,D0,2728,maiz
Nuevo León,21801,20791,2011,2,NPS,1010,maiz
Oaxaca,515613,463675,2011,2,NPS,51938,maiz
Puebla,516522,479882,2011,2,NPS,36640,maiz
Querétaro de Arteaga,93922,79022,2011,2,NPS,14900,maiz
Quintana Roo,64580,59112,2011,2,D0,5468,maiz
San Luis Potosí,236525,133079,2011,2,NPS,103446,maiz
Sinaloa,34246,26680,2011,2,D0,7566,maiz
Sonora,4109,3599,2011,2,D2,510,maiz
Tabasco,48133,31602,2011,2,NPS,16531,maiz
Tamaulipas,54669,45099,2011,2,NPS,9570,maiz
Tlaxcala,103886,103359,2011,2,NPS,527,maiz
Veracruz de Ignacio de la Llave,385125,311838,2011,2,NPS,73287,maiz
Yucatán,144249,131806,2011,2,D0,12443,maiz
Zacatecas,241902,149146,2011,2,NPS,92756,maiz
Coahuila de Zaragoza,12047,4952,2011,2,NPS,7095,maiz
Chiapas,572338,600,2011,7,NPS,571738,maiz
Nayarit,25545,11,2011,7,D2,25534,maiz
Coahuila de Zaragoza,5463,7,2011,8,D3,5456,maiz
Chiapas,592676,600,2011,8,NPS,592076,maiz
Hidalgo,164793,2379,2011,8,D1,162414,maiz
Nayarit,34204,11,2011,8,D1,34193,maiz
Tabasco,46652,5085,2011,8,D1,41567,maiz
Veracruz de Ignacio de la Llave,362498,4719,2011,8,D1,357779,maiz
Coahuila de Zaragoza,17282,5,2011,9,D3,17277,maiz
Chiapas,594973,29526,2011,9,NPS,565447,maiz
Chihuahua,55288,1471,2011,9,D2,53817,maiz
Hidalgo,165093,6141,2011,9,NPS,158952,maiz
Nayarit,35294,11,2011,9,NPS,35283,maiz
Nuevo León,6608,200,2011,9,D3,6408,maiz
Oaxaca,519570,4450,2011,9,NPS,515120,maiz
Sinaloa,13667,4265,2011,9,NPS,9402,maiz
Tabasco,48907,13363,2011,9,NPS,35544,maiz
Veracruz de Ignacio de la Llave,370853,8795,2011,9,NPS,362058,maiz
Yucatán,142704,350,2011,9,NPS,142354,maiz
Campeche,161194,5005,2011,10,NPS,156189,maiz
Coahuila de Zaragoza,24483,18,2011,10,D4,24465,maiz
Colima,8521,10,2011,10,NPS,8511,maiz
Chiapas,594973,65752,2011,10,NPS,529221,maiz
Chihuahua,55288,11279,2011,10,D3,44009,maiz
Ciudad de México,5199,326,2011,10,D0,4873,maiz
Durango,117352,9891,2011,10,D3,107461,maiz
Guerrero,436515,24643,2011,10,NPS,411872,maiz
Hidalgo,165768,12486,2011,10,D0,153282,maiz
Jalisco,564005,8301,2011,10,D2,555704,maiz
Estado de México,413517,1722,2011,10,D0,411795,maiz
Michoacán de Ocampo,359539,3366,2011,10,D0,356173,maiz
Nayarit,35351,11,2011,10,NPS,35340,maiz
Nuevo León,7129,1450,2011,10,D3,5679,maiz
Oaxaca,519570,45633,2011,10,NPS,473937,maiz
Puebla,511151,100,2011,10,NPS,511051,maiz
Querétaro de Arteaga,86142,6,2011,10,D2,86136,maiz
Quintana Roo,63639,3548,2011,10,NPS,60091,maiz
San Luis Potosí,172742,430,2011,10,D1,172312,maiz
Sinaloa,18394,4265,2011,10,D1,14129,maiz
Sonora,1990,111,2011,10,D3,1879,maiz
Tabasco,48907,27038,2011,10,NPS,21869,maiz
Tlaxcala,105783,10397,2011,10,NPS,95386,maiz
Veracruz de Ignacio de la Llave,376223,88653,2011,10,D0,287570,maiz
Yucatán,142704,13606,2011,10,NPS,129098,maiz
Zacatecas,187470,2866,2011,10,D3,184604,maiz
Campeche,161194,24482,2011,11,NPS,136712,maiz
Coahuila de Zaragoza,14765,2100,2011,11,D4,12665,maiz
Colima,9862,4435,2011,11,NPS,5427,maiz
Chiapas,594973,157669,2011,11,NPS,437304,maiz
Chihuahua,55288,20514,2011,11,D3,34774,maiz
Ciudad de México,5199,2413,2011,11,D0,2786,maiz
Durango,117352,32773,2011,11,D3,84579,maiz
Guanajuato,286234,40122,2011,11,D2,246112,maiz
Guerrero,436553,269804,2011,11,NPS,166749,maiz
Hidalgo,165768,74670,2011,11,D0,91098,maiz
Jalisco,564005,159336,2011,11,D2,404669,maiz
Estado de México,416771,92264,2011,11,D0,324507,maiz
Michoacán de Ocampo,359539,88113,2011,11,D0,271426,maiz
Morelos,26090,13614,2011,11,NPS,12476,maiz
Nayarit,35351,10749,2011,11,NPS,24602,maiz
Nuevo León,7129,1606,2011,11,D3,5523,maiz
Oaxaca,519570,239407,2011,11,NPS,280163,maiz
Puebla,511151,167111,2011,11,NPS,344040,maiz
Querétaro de Arteaga,86142,3906,2011,11,D2,82236,maiz
Quintana Roo,63639,28403,2011,11,NPS,35236,maiz
San Luis Potosí,172742,10946,2011,11,D2,161796,maiz
Sinaloa,36390,6575,2011,11,D1,29815,maiz
Sonora,2890,354,2011,11,D0,2536,maiz
Tabasco,48907,27038,2011,11,NPS,21869,maiz
Tamaulipas,54881,13742,2011,11,D1,41139,maiz
Tlaxcala,105782,22589,2011,11,NPS,83193,maiz
Veracruz de Ignacio de la Llave,376453,176984,2011,11,D0,199469,maiz
Yucatán,142704,54255,2011,11,NPS,88449,maiz
Zacatecas,187470,40887,2011,11,D3,146583,maiz
Coahuila de Zaragoza,10329,68,2011,11,D4,10261,maiz
Campeche,161194,125784,2012,1,NPS,35410,maiz
Coahuila de Zaragoza,14765,2112,2012,1,D3,12653,maiz
Colima,9862,7336,2012,1,D0,2526,maiz
Chiapas,594973,480880,2012,1,NPS,114093,maiz
Chihuahua,55288,20546,2012,1,D3,34742,maiz
Ciudad de México,5199,4433,2012,1,D0,766,maiz
Durango,115791,62249,2012,1,D3,53542,maiz
Guanajuato,286234,97430,2012,1,D2,188804,maiz
Guerrero,436553,418728,2012,1,NPS,17825,maiz
Hidalgo,165768,123068,2012,1,D0,42700,maiz
Jalisco,564005,446512,2012,1,D1,117493,maiz
Estado de México,406944,257415,2012,1,D0,149529,maiz
Michoacán de Ocampo,359539,299031,2012,1,D1,60508,maiz
Morelos,26090,24228,2012,1,NPS,1862,maiz
Nayarit,36021,35622,2012,1,D1,399,maiz
Nuevo León,7129,1720,2012,1,D2,5409,maiz
Oaxaca,519570,487473,2012,1,NPS,32097,maiz
Puebla,511151,353046,2012,1,NPS,158105,maiz
Querétaro de Arteaga,86142,23728,2012,1,D1,62414,maiz
Quintana Roo,63639,57539,2012,1,NPS,6100,maiz
San Luis Potosí,172742,66391,2012,1,D0,106351,maiz
Sinaloa,39620,13212,2012,1,D1,26408,maiz
Sonora,2904,2654,2012,1,D0,250,maiz
Tabasco,48907,43516,2012,1,NPS,5391,maiz
Tamaulipas,54881,17429,2012,1,D0,37452,maiz
Tlaxcala,105782,61576,2012,1,NPS,44206,maiz
Veracruz de Ignacio de la Llave,376568,329553,2012,1,NPS,47015,maiz
Yucatán,142771,131025,2012,1,NPS,11746,maiz
Zacatecas,187470,54346,2012,1,D3,133124,maiz
Coahuila de Zaragoza,10329,98,2012,1,D3,10231,maiz
Campeche,162021,159546,2012,2,NPS,2475,maiz
Coahuila de Zaragoza,14765,2112,2012,2,D3,12653,maiz
Colima,9862,7537,2012,2,NPS,2325,maiz
Chiapas,594973,576391,2012,2,NPS,18582,maiz
Chihuahua,55288,20546,2012,2,D3,34742,maiz
Ciudad de México,5199,4433,2012,2,NPS,766,maiz
Durango,115791,62249,2012,2,D3,53542,maiz
Guanajuato,286234,97430,2012,2,D1,188804,maiz
Guerrero,436553,426850,2012,2,NPS,9703,maiz
Hidalgo,165768,123068,2012,2,NPS,42700,maiz
Jalisco,564005,480256,2012,2,NPS,83749,maiz
Estado de México,406944,257415,2012,2,NPS,149529,maiz
Michoacán de Ocampo,359539,331209,2012,2,NPS,28330,maiz
Morelos,26090,26090,2012,2,NPS,0,maiz
Nayarit,36021,35622,2012,2,D0,399,maiz
Nuevo León,7129,1743,2012,2,D2,5386,maiz
Oaxaca,519570,487473,2012,2,NPS,32097,maiz
Puebla,511151,374994,2012,2,NPS,136157,maiz
Querétaro de Arteaga,86142,23912,2012,2,D1,62230,maiz
Quintana Roo,63639,63639,2012,2,NPS,0,maiz
San Luis Potosí,172742,68787,2012,2,NPS,103955,maiz
Sinaloa,39620,33479,2012,2,D1,6141,maiz
Sonora,2904,2904,2012,2,D0,0,maiz
Tabasco,48907,43516,2012,2,NPS,5391,maiz
Tamaulipas,54881,26124,2012,2,NPS,28757,maiz
Tlaxcala,105782,71149,2012,2,NPS,34633,maiz
Veracruz de Ignacio de la Llave,376568,354117,2012,2,NPS,22451,maiz
Yucatán,142771,140254,2012,2,NPS,2517,maiz
Zacatecas,187470,54346,2012,2,D1,133124,maiz
Coahuila de Zaragoza,10329,98,2012,2,D3,10231,maiz
Coahuila de Zaragoza,11863,116,2012,8,D1,11747,maiz
Tabasco,49702,3702,2012,8,NPS,46000,maiz
Veracruz de Ignacio de la Llave,344831,1799,2012,8,NPS,343032,maiz
Baja California,294,13,2012,9,NPS,281,maiz
Campeche,160271,3767,2012,9,NPS,156504,maiz
Coahuila de Zaragoza,18456,140,2012,9,D1,18316,maiz
Colima,8562,3,2012,9,NPS,8559,maiz
Chiapas,591775,10745,2012,9,NPS,581030,maiz
Chihuahua,105630,1522,2012,9,D1,104108,maiz
Guerrero,432525,1796,2012,9,NPS,430729,maiz
Oaxaca,519193,1436,2012,9,NPS,517757,maiz
Quintana Roo,71041,1155,2012,9,NPS,69886,maiz
Tabasco,50152,24053,2012,9,NPS,26099,maiz
Tamaulipas,46609,205,2012,9,NPS,46404,maiz
Veracruz de Ignacio de la Llave,371866,12814,2012,9,NPS,359052,maiz
Aguascalientes,35322,2891,2012,10,NPS,32431,maiz
Baja California,294,13,2012,10,NPS,281,maiz
Campeche,160271,18170,2012,10,NPS,142101,maiz
Coahuila de Zaragoza,18470,2998,2012,10,D1,15472,maiz
Colima,8758,107,2012,10,NPS,8651,maiz
Chiapas,591775,61454,2012,10,NPS,530321,maiz
Chihuahua,106030,19078,2012,10,D0,86952,maiz
Durango,130329,15137,2012,10,D0,115192,maiz
Guanajuato,274314,10396,2012,10,NPS,263918,maiz
Guerrero,432525,8358,2012,10,NPS,424167,maiz
Hidalgo,177795,7026,2012,10,NPS,170769,maiz
Jalisco,565486,15977,2012,10,NPS,549509,maiz
Estado de México,458851,13744,2012,10,NPS,445107,maiz
Michoacán de Ocampo,381218,3099,2012,10,NPS,378119,maiz
Morelos,22486,733,2012,10,NPS,21753,maiz
Nuevo León,28587,18132,2012,10,NPS,10455,maiz
Oaxaca,519193,34101,2012,10,NPS,485092,maiz
Puebla,505739,6142,2012,10,NPS,499597,maiz
Querétaro de Arteaga,89916,1540,2012,10,NPS,88376,maiz
Quintana Roo,71241,4487,2012,10,NPS,66754,maiz
San Luis Potosí,159282,300,2012,10,NPS,158982,maiz
Sinaloa,40991,2443,2012,10,NPS,38548,maiz
Sonora,2554,237,2012,10,NPS,2317,maiz
Tabasco,52802,41440,2012,10,NPS,11362,maiz
Tamaulipas,47238,205,2012,10,NPS,47033,maiz
Tlaxcala,101332,50,2012,10,NPS,101282,maiz
Veracruz de Ignacio de la Llave,374961,38202,2012,10,NPS,336759,maiz
Yucatán,133761,13894,2012,10,NPS,119867,maiz
Zacatecas,138154,15826,2012,10,NPS,122328,maiz
Aguascalientes,35322,13533,2012,11,NPS,21789,maiz
Baja California,294,13,2012,11,D0,281,maiz
Campeche,160271,47525,2012,11,NPS,112746,maiz
Coahuila de Zaragoza,18470,7537,2012,11,D1,10933,maiz
Colima,8758,1647,2012,11,NPS,7111,maiz
Chiapas,591775,160655,2012,11,NPS,431120,maiz
Chihuahua,80618,77713,2012,11,NPS,2905,maiz
Ciudad de México,4003,2405,2012,11,NPS,1598,maiz
Durango,127755,47625,2012,11,NPS,80130,maiz
Guanajuato,274314,87039,2012,11,NPS,187275,maiz
Guerrero,432525,214370,2012,11,NPS,218155,maiz
Hidalgo,177795,135558,2012,11,NPS,42237,maiz
Jalisco,565486,124070,2012,11,NPS,441416,maiz
Estado de México,458851,144238,2012,11,NPS,314613,maiz
Michoacán de Ocampo,381218,111642,2012,11,NPS,269576,maiz
Morelos,23122,7633,2012,11,NPS,15489,maiz
Nayarit,36666,5826,2012,11,NPS,30840,maiz
Nuevo León,28587,18228,2012,11,D0,10359,maiz
Oaxaca,519193,252285,2012,11,NPS,266908,maiz
Puebla,505739,174914,2012,11,NPS,330825,maiz
Querétaro de Arteaga,89916,8010,2012,11,NPS,81906,maiz
Quintana Roo,71241,10055,2012,11,NPS,61186,maiz
San Luis Potosí,159282,48236,2012,11,D0,111046,maiz
Sinaloa,41076,6319,2012,11,NPS,34757,maiz
Sonora,2560,554,2012,11,D1,2006,maiz
Tabasco,52802,47876,2012,11,NPS,4926,maiz
Tamaulipas,47238,15005,2012,11,NPS,32233,maiz
Tlaxcala,101332,14664,2012,11,NPS,86668,maiz
Veracruz de Ignacio de la Llave,375040,160855,2012,11,NPS,214185,maiz
Yucatán,133761,39035,2012,11,NPS,94726,maiz
Zacatecas,138154,46559,2012,11,D0,91595,maiz
Coahuila de Zaragoza,10259,6899,2012,11,D1,3360,maiz
Aguascalientes,35322,13533,2013,1,NPS,21789,maiz
Baja California,294,13,2013,1,D0,281,maiz
Campeche,160271,134933,2013,1,NPS,25338,maiz
Coahuila de Zaragoza,18470,8574,2013,1,D1,9896,maiz
Colima,8758,8668,2013,1,NPS,90,maiz
Chiapas,591775,525868,2013,1,NPS,65907,maiz
Chihuahua,80618,78070,2013,1,NPS,2548,maiz
Ciudad de México,4003,4003,2013,1,NPS,0,maiz
Durango,127755,118460,2013,1,NPS,9295,maiz
Guanajuato,274314,224606,2013,1,NPS,49708,maiz
Guerrero,432525,414241,2013,1,NPS,18284,maiz
Hidalgo,177795,167109,2013,1,NPS,10686,maiz
Jalisco,565486,527941,2013,1,NPS,37545,maiz
Estado de México,467578,431812,2013,1,NPS,35766,maiz
Michoacán de Ocampo,381218,348899,2013,1,NPS,32319,maiz
Morelos,23122,21404,2013,1,NPS,1718,maiz
Nayarit,36666,31760,2013,1,NPS,4906,maiz
Nuevo León,28587,26195,2013,1,D1,2392,maiz
Oaxaca,519193,516598,2013,1,NPS,2595,maiz
Puebla,505739,487812,2013,1,NPS,17927,maiz
Querétaro de Arteaga,89916,81496,2013,1,NPS,8420,maiz
Quintana Roo,71241,41038,2013,1,NPS,30203,maiz
San Luis Potosí,159282,67123,2013,1,NPS,92159,maiz
Sinaloa,41076,31691,2013,1,NPS,9385,maiz
Sonora,2560,2554,2013,1,D1,6,maiz
Tabasco,52802,51355,2013,1,NPS,1447,maiz
Tamaulipas,47238,19053,2013,1,D0,28185,maiz
Tlaxcala,101332,94173,2013,1,NPS,7159,maiz
Veracruz de Ignacio de la Llave,375040,341010,2013,1,NPS,34030,maiz
Yucatán,133766,105417,2013,1,NPS,28349,maiz
Zacatecas,138154,94296,2013,1,NPS,43858,maiz
Coahuila de Zaragoza,10259,8020,2013,1,D1,2239,maiz
Aguascalientes,35672,17099,2013,2,NPS,18573,maiz
Baja California,294,13,2013,2,D0,281,maiz
Campeche,160271,141993,2013,2,NPS,18278,maiz
Coahuila de Zaragoza,18470,8574,2013,2,D1,9896,maiz
Colima,8758,8668,2013,2,NPS,90,maiz
Chiapas,591775,590939,2013,2,NPS,836,maiz
Chihuahua,80618,78070,2013,2,NPS,2548,maiz
Ciudad de México,4003,4003,2013,2,D0,0,maiz
Durango,127755,118460,2013,2,NPS,9295,maiz
Guanajuato,274314,224606,2013,2,D0,49708,maiz
Guerrero,432525,424830,2013,2,NPS,7695,maiz
Hidalgo,177795,167109,2013,2,NPS,10686,maiz
Jalisco,565486,543877,2013,2,NPS,21609,maiz
Estado de México,467578,431812,2013,2,NPS,35766,maiz
Michoacán de Ocampo,381218,364094,2013,2,D0,17124,maiz
Morelos,23122,23122,2013,2,NPS,0,maiz
Nayarit,36666,35346,2013,2,D1,1320,maiz
Nuevo León,28587,26195,2013,2,D0,2392,maiz
Oaxaca,519193,516698,2013,2,NPS,2495,maiz
Puebla,505739,497699,2013,2,NPS,8040,maiz
Querétaro de Arteaga,89916,82966,2013,2,NPS,6950,maiz
Quintana Roo,71241,48901,2013,2,NPS,22340,maiz
San Luis Potosí,159282,69846,2013,2,NPS,89436,maiz
Sinaloa,41076,33822,2013,2,NPS,7254,maiz
Sonora,2560,2554,2013,2,D1,6,maiz
Tabasco,52802,51355,2013,2,D0,1447,maiz
Tamaulipas,47238,19595,2013,2,NPS,27643,maiz
Tlaxcala,101332,94178,2013,2,D0,7154,maiz
Veracruz de Ignacio de la Llave,375040,352284,2013,2,NPS,22756,maiz
Yucatán,133766,114788,2013,2,NPS,18978,maiz
Zacatecas,138154,96716,2013,2,NPS,41438,maiz
Coahuila de Zaragoza,10259,8020,2013,2,D1,2239,maiz
Coahuila de Zaragoza,14261,66,2013,8,NPS,14195,maiz
Chiapas,591374,2600,2013,8,NPS,588774,maiz
Quintana Roo,72009,1025,2013,8,NPS,70984,maiz
Tabasco,48385,3950,2013,8,NPS,44435,maiz
Veracruz de Ignacio de la Llave,377236,1799,2013,8,NPS,375437,maiz
Coahuila de Zaragoza,18839,258,2013,9,NPS,18581,maiz
Chiapas,592018,10657,2013,9,NPS,581361,maiz
Hidalgo,165225,605,2013,9,NPS,164620,maiz
Nuevo León,43242,19105,2013,9,NPS,24137,maiz
Oaxaca,518166,10036,2013,9,NPS,508130,maiz
Quintana Roo,73209,9745,2013,9,NPS,63464,maiz
San Luis Potosí,203346,20,2013,9,NPS,203326,maiz
Sonora,2587,2,2013,9,NPS,2585,maiz
Tabasco,50530,16775,2013,9,NPS,33755,maiz
Veracruz de Ignacio de la Llave,384703,11325,2013,9,NPS,373378,maiz
Yucatán,128888,1700,2013,9,NPS,127188,maiz
Aguascalientes,35780,7363,2013,10,NPS,28417,maiz
Baja California,218,218,2013,10,D1,0,maiz
Campeche,173581,592,2013,10,NPS,172989,maiz
Coahuila de Zaragoza,21994,3314,2013,10,NPS,18680,maiz
Colima,9582,6,2013,10,NPS,9576,maiz
Chiapas,592018,83063,2013,10,NPS,508955,maiz
Chihuahua,79536,32036,2013,10,NPS,47500,maiz
Ciudad de México,3957,60,2013,10,NPS,3897,maiz
Guanajuato,279836,14505,2013,10,NPS,265331,maiz
Guerrero,435828,4181,2013,10,NPS,431647,maiz
Hidalgo,165225,18586,2013,10,NPS,146639,maiz
Jalisco,541549,106582,2013,10,NPS,434967,maiz
Estado de México,456926,393,2013,10,NPS,456533,maiz
Michoacán de Ocampo,368061,23496,2013,10,NPS,344565,maiz
Nuevo León,43472,19131,2013,10,NPS,24341,maiz
Oaxaca,518166,54662,2013,10,NPS,463504,maiz
Puebla,487380,8854,2013,10,NPS,478526,maiz
Quintana Roo,74029,20266,2013,10,NPS,53763,maiz
San Luis Potosí,203346,15818,2013,10,NPS,187528,maiz
Sinaloa,42100,30,2013,10,NPS,42070,maiz
Sonora,2587,125,2013,10,NPS,2462,maiz
Tabasco,50530,35161,2013,10,NPS,15369,maiz
Tamaulipas,50409,2036,2013,10,NPS,48373,maiz
Tlaxcala,85992,4870,2013,10,NPS,81122,maiz
Veracruz de Ignacio de la Llave,384703,66823,2013,10,NPS,317880,maiz
Yucatán,129489,21670,2013,10,NPS,107819,maiz
Zacatecas,168121,11355,2013,10,NPS,156766,maiz
Aguascalientes,37091,33570,2013,11,NPS,3521,maiz
Baja California,218,218,2013,11,NPS,0,maiz
Campeche,173581,13607,2013,11,NPS,159974,maiz
Coahuila de Zaragoza,25849,14166,2013,11,NPS,11683,maiz
Colima,9582,2489,2013,11,NPS,7093,maiz
Chiapas,592018,163542,2013,11,NPS,428476,maiz
Chihuahua,79312,69193,2013,11,NPS,10119,maiz
Ciudad de México,3957,606,2013,11,NPS,3351,maiz
Durango,117622,43306,2013,11,NPS,74316,maiz
Guanajuato,279836,111571,2013,11,NPS,168265,maiz
Guerrero,435828,162348,2013,11,NPS,273480,maiz
Hidalgo,165225,81576,2013,11,NPS,83649,maiz
Jalisco,541549,184235,2013,11,NPS,357314,maiz
Estado de México,456926,89328,2013,11,NPS,367598,maiz
Michoacán de Ocampo,368061,124888,2013,11,NPS,243173,maiz
Morelos,24254,11532,2013,11,NPS,12722,maiz
Nayarit,39630,4728,2013,11,NPS,34902,maiz
Nuevo León,43472,37804,2013,11,NPS,5668,maiz
Oaxaca,518166,219687,2013,11,NPS,298479,maiz
Puebla,487380,170414,2013,11,NPS,316966,maiz
Querétaro de Arteaga,85811,15915,2013,11,NPS,69896,maiz
Quintana Roo,74029,37253,2013,11,NPS,36776,maiz
San Luis Potosí,203346,80336,2013,11,NPS,123010,maiz
Sinaloa,43834,3092,2013,11,NPS,40742,maiz
Sonora,2587,365,2013,11,NPS,2222,maiz
Tabasco,50530,45028,2013,11,NPS,5502,maiz
Tamaulipas,50409,24136,2013,11,NPS,26273,maiz
Tlaxcala,85992,14096,2013,11,NPS,71896,maiz
Veracruz de Ignacio de la Llave,384703,166931,2013,11,NPS,217772,maiz
Yucatán,129489,48623,2013,11,NPS,80866,maiz
Zacatecas,168121,93710,2013,11,NPS,74411,maiz
Coahuila de Zaragoza,10208,3806,2013,11,NPS,6402,maiz
Aguascalientes,37091,33570,2014,1,NPS,3521,maiz
Baja California,218,218,2014,1,D2,0,maiz
Campeche,173581,139744,2014,1,NPS,33837,maiz
Coahuila de Zaragoza,25849,25833,2014,1,NPS,16,maiz
Colima,9582,9424,2014,1,NPS,158,maiz
Chiapas,592018,515927,2014,1,NPS,76091,maiz
Chihuahua,79312,79170,2014,1,NPS,142,maiz
Ciudad de México,3957,3621,2014,1,NPS,336,maiz
Durango,130625,126002,2014,1,NPS,4623,maiz
Guanajuato,279836,269353,2014,1,NPS,10483,maiz
Guerrero,435828,340912,2014,1,NPS,94916,maiz
Hidalgo,165225,159863,2014,1,NPS,5362,maiz
Jalisco,541549,438228,2014,1,NPS,103321,maiz
Estado de México,456926,432438,2014,1,NPS,24488,maiz
Michoacán de Ocampo,368061,308965,2014,1,NPS,59096,maiz
Morelos,24254,23902,2014,1,NPS,352,maiz
Nayarit,39630,33478,2014,1,NPS,6152,maiz
Nuevo León,43472,43222,2014,1,NPS,250,maiz
Oaxaca,518166,442131,2014,1,NPS,76035,maiz
Puebla,487380,462922,2014,1,NPS,24458,maiz
Querétaro de Arteaga,85811,83972,2014,1,NPS,1839,maiz
Quintana Roo,74029,66796,2014,1,NPS,7233,maiz
San Luis Potosí,203346,129653,2014,1,NPS,73693,maiz
Sinaloa,44158,18807,2014,1,NPS,25351,maiz
Sonora,2587,2587,2014,1,D0,0,maiz
Tabasco,50530,47988,2014,1,NPS,2542,maiz
Tamaulipas,50409,44754,2014,1,NPS,5655,maiz
Tlaxcala,85992,73419,2014,1,NPS,12573,maiz
Veracruz de Ignacio de la Llave,384703,365290,2014,1,NPS,19413,maiz
Yucatán,129489,113756,2014,1,NPS,15733,maiz
Zacatecas,168121,162944,2014,1,NPS,5177,maiz
Coahuila de Zaragoza,10211,9354,2014,1,NPS,857,maiz
Aguascalientes,37091,33570,2014,2,NPS,3521,maiz
Baja California,218,218,2014,2,D2,0,maiz
Campeche,173581,172797,2014,2,NPS,784,maiz
Coahuila de Zaragoza,25849,25833,2014,2,NPS,16,maiz
Colima,9582,9424,2014,2,NPS,158,maiz
Chiapas,592018,590096,2014,2,NPS,1922,maiz
Chihuahua,79312,79170,2014,2,NPS,142,maiz
Ciudad de México,3957,3957,2014,2,NPS,0,maiz
Durango,130625,126999,2014,2,NPS,3626,maiz
Guanajuato,279836,270729,2014,2,NPS,9107,maiz
Guerrero,435828,373718,2014,2,D0,62110,maiz
Hidalgo,165225,159863,2014,2,NPS,5362,maiz
Jalisco,541549,537429,2014,2,NPS,4120,maiz
Estado de México,456926,453608,2014,2,NPS,3318,maiz
Michoacán de Ocampo,368061,334147,2014,2,NPS,33914,maiz
Morelos,24254,24114,2014,2,NPS,140,maiz
Nayarit,39630,39630,2014,2,NPS,0,maiz
Nuevo León,43472,43222,2014,2,NPS,250,maiz
Oaxaca,518166,443475,2014,2,NPS,74691,maiz
Puebla,487380,481640,2014,2,NPS,5740,maiz
Querétaro de Arteaga,85811,85522,2014,2,NPS,289,maiz
Quintana Roo,74029,72959,2014,2,NPS,1070,maiz
San Luis Potosí,203346,138029,2014,2,NPS,65317,maiz
Sinaloa,44158,43025,2014,2,D0,1133,maiz
Sonora,2587,2587,2014,2,D0,0,maiz
Tabasco,50530,48293,2014,2,NPS,2237,maiz
Tamaulipas,50409,46328,2014,2,NPS,4081,maiz
Tlaxcala,85992,85992,2014,2,NPS,0,maiz
Veracruz de Ignacio de la Llave,384703,378840,2014,2,NPS,5863,maiz
Yucatán,129489,126921,2014,2,NPS,2568,maiz
Zacatecas,168121,164998,2014,2,NPS,3123,maiz
Coahuila de Zaragoza,10211,9354,2014,2,NPS,857,maiz
Aguascalientes,37091,33570,2014,3,NPS,3521,maiz
Baja California,218,218,2014,3,D0,0,maiz
Campeche,173581,172797,2014,3,NPS,784,maiz
Coahuila de Zaragoza,25849,25833,2014,3,NPS,16,maiz
Colima,9582,9424,2014,3,NPS,158,maiz
Chiapas,592018,590096,2014,3,NPS,1922,maiz
Chihuahua,79312,79170,2014,3,NPS,142,maiz
Ciudad de México,3957,3957,2014,3,NPS,0,maiz
Durango,130625,126999,2014,3,NPS,3626,maiz
Guanajuato,279836,270729,2014,3,NPS,9107,maiz
Guerrero,435828,373718,2014,3,NPS,62110,maiz
Hidalgo,165225,159863,2014,3,NPS,5362,maiz
Jalisco,541549,537429,2014,3,NPS,4120,maiz
Estado de México,456926,453608,2014,3,NPS,3318,maiz
Michoacán de Ocampo,368061,334147,2014,3,NPS,33914,maiz
Morelos,24254,24114,2014,3,NPS,140,maiz
Nayarit,39630,39630,2014,3,NPS,0,maiz
Nuevo León,43472,43222,2014,3,NPS,250,maiz
Oaxaca,518166,443475,2014,3,NPS,74691,maiz
Puebla,487380,481640,2014,3,NPS,5740,maiz
Querétaro de Arteaga,85811,85522,2014,3,NPS,289,maiz
Quintana Roo,74029,72959,2014,3,NPS,1070,maiz
San Luis Potosí,203346,138029,2014,3,NPS,65317,maiz
Sinaloa,44158,43025,2014,3,NPS,1133,maiz
Sonora,2587,2587,2014,3,D0,0,maiz
Tabasco,50530,48293,2014,3,NPS,2237,maiz
Tamaulipas,50409,46328,2014,3,NPS,4081,maiz
Tlaxcala,85992,85992,2014,3,NPS,0,maiz
Veracruz de Ignacio de la Llave,384703,378840,2014,3,NPS,5863,maiz
Yucatán,129489,126921,2014,3,NPS,2568,maiz
Zacatecas,168121,164998,2014,3,NPS,3123,maiz
Coahuila de Zaragoza,10211,9354,2014,3,NPS,857,maiz
Tabasco,49802,7112,2014,8,NPS,42690,maiz
Veracruz de Ignacio de la Llave,371497,1909,2014,8,NPS,369588,maiz
Coahuila de Zaragoza,27084,2330,2014,9,NPS,24754,maiz
Hidalgo,172752,560,2014,9,NPS,172192,maiz
Michoacán de Ocampo,375091,2548,2014,9,D0,372543,maiz
Nuevo León,54681,18,2014,9,NPS,54663,maiz
Oaxaca,493192,5617,2014,9,NPS,487575,maiz
Quintana Roo,70846,850,2014,9,D0,69996,maiz
San Luis Potosí,215647,3000,2014,9,NPS,212647,maiz
Sonora,1802,50,2014,9,NPS,1752,maiz
Tabasco,49802,17609,2014,9,D0,32193,maiz
Veracruz de Ignacio de la Llave,376167,5828,2014,9,NPS,370339,maiz
Aguascalientes,33710,21613,2014,10,NPS,12097,maiz
Campeche,174921,14820,2014,10,NPS,160101,maiz
Coahuila de Zaragoza,27084,9165,2014,10,NPS,17919,maiz
Colima,9634,6,2014,10,NPS,9628,maiz
Chiapas,589033,27512,2014,10,NPS,561521,maiz
Chihuahua,117332,39985,2014,10,NPS,77347,maiz
Durango,154482,28995,2014,10,NPS,125487,maiz
Guanajuato,263484,510,2014,10,NPS,262974,maiz
Guerrero,434787,4475,2014,10,NPS,430312,maiz
Hidalgo,172752,14558,2014,10,NPS,158194,maiz
Jalisco,509104,770,2014,10,NPS,508334,maiz
Estado de México,456481,1822,2014,10,NPS,454659,maiz
Michoacán de Ocampo,375091,8476,2014,10,D0,366615,maiz
Nuevo León,54681,33,2014,10,NPS,54648,maiz
Oaxaca,493192,44996,2014,10,NPS,448196,maiz
Puebla,485614,47362,2014,10,NPS,438252,maiz
Quintana Roo,70846,12020,2014,10,NPS,58826,maiz
San Luis Potosí,215647,59168,2014,10,NPS,156479,maiz
Sinaloa,42561,2276,2014,10,NPS,40285,maiz
Sonora,1802,120,2014,10,NPS,1682,maiz
Tabasco,49802,24198,2014,10,NPS,25604,maiz
Tlaxcala,99068,245,2014,10,NPS,98823,maiz
Veracruz de Ignacio de la Llave,376167,58742,2014,10,NPS,317425,maiz
Yucatán,123369,5276,2014,10,NPS,118093,maiz
Zacatecas,183647,9624,2014,10,NPS,174023,maiz
Aguascalientes,33710,28013,2014,11,NPS,5697,maiz
Campeche,174921,27605,2014,11,NPS,147316,maiz
Coahuila de Zaragoza,27084,14594,2014,11,NPS,12490,maiz
Colima,9634,1179,2014,11,NPS,8455,maiz
Chiapas,589033,135036,2014,11,NPS,453997,maiz
Chihuahua,117152,83396,2014,11,NPS,33756,maiz
Ciudad de México,3965,178,2014,11,NPS,3787,maiz
Durango,154482,56037,2014,11,NPS,98445,maiz
Guanajuato,263484,91777,2014,11,NPS,171707,maiz
Guerrero,434787,138849,2014,11,NPS,295938,maiz
Hidalgo,172752,111242,2014,11,NPS,61510,maiz
Jalisco,509104,18584,2014,11,NPS,490520,maiz
Estado de México,456481,142757,2014,11,NPS,313724,maiz
Michoacán de Ocampo,375091,98136,2014,11,NPS,276955,maiz
Morelos,23341,12117,2014,11,NPS,11224,maiz
Nayarit,34120,1594,2014,11,NPS,32526,maiz
Nuevo León,54681,19296,2014,11,NPS,35385,maiz
Oaxaca,493192,183750,2014,11,NPS,309442,maiz
Puebla,485614,207026,2014,11,NPS,278588,maiz
Querétaro de Arteaga,85219,25285,2014,11,NPS,59934,maiz
Quintana Roo,70846,23396,2014,11,NPS,47450,maiz
San Luis Potosí,215647,111874,2014,11,NPS,103773,maiz
Sinaloa,42561,8176,2014,11,NPS,34385,maiz
Sonora,1802,310,2014,11,NPS,1492,maiz
Tabasco,49802,37860,2014,11,NPS,11942,maiz
Tamaulipas,47949,8159,2014,11,NPS,39790,maiz
Tlaxcala,99068,4815,2014,11,NPS,94253,maiz
Veracruz de Ignacio de la Llave,376167,155421,2014,11,NPS,220746,maiz
Yucatán,123369,24214,2014,11,NPS,99155,maiz
Zacatecas,183647,68950,2014,11,NPS,114697,maiz
Coahuila de Zaragoza,14975,2683,2014,11,NPS,12292,maiz
Aguascalientes,33710,28013,2015,1,NPS,5697,maiz
Campeche,174921,156390,2015,1,NPS,18531,maiz
Coahuila de Zaragoza,27084,27057,2015,1,NPS,27,maiz
Colima,9634,9634,2015,1,NPS,0,maiz
Chiapas,589033,556606,2015,1,NPS,32427,maiz
Chihuahua,117152,117142,2015,1,NPS,10,maiz
Ciudad de México,3965,3965,2015,1,NPS,0,maiz
Durango,154482,150620,2015,1,NPS,3862,maiz
Guanajuato,263484,253695,2015,1,NPS,9789,maiz
Guerrero,434787,385238,2015,1,D0,49549,maiz
Hidalgo,172752,168564,2015,1,NPS,4188,maiz
Jalisco,509104,474246,2015,1,NPS,34858,maiz
Estado de México,456481,417137,2015,1,NPS,39344,maiz
Michoacán de Ocampo,375091,333617,2015,1,D0,41474,maiz
Morelos,23341,23272,2015,1,NPS,69,maiz
Nayarit,34120,31857,2015,1,NPS,2263,maiz
Nuevo León,54681,52086,2015,1,NPS,2595,maiz
Oaxaca,493192,457000,2015,1,NPS,36192,maiz
Puebla,485614,371059,2015,1,NPS,114555,maiz
Querétaro de Arteaga,85219,78059,2015,1,NPS,7160,maiz
Quintana Roo,70846,45561,2015,1,NPS,25285,maiz
San Luis Potosí,215647,152603,2015,1,NPS,63044,maiz
Sinaloa,42561,35569,2015,1,NPS,6992,maiz
Sonora,1802,1802,2015,1,NPS,0,maiz
Tabasco,49802,41076,2015,1,NPS,8726,maiz
Tamaulipas,47854,21736,2015,1,NPS,26118,maiz
Tlaxcala,99068,97459,2015,1,NPS,1609,maiz
Veracruz de Ignacio de la Llave,376167,282591,2015,1,NPS,93576,maiz
Yucatán,123369,88656,2015,1,NPS,34713,maiz
Zacatecas,183647,150010,2015,1,NPS,33637,maiz
Coahuila de Zaragoza,14975,12397,2015,1,NPS,2578,maiz
Aguascalientes,33710,28013,2015,2,NPS,5697,maiz
Campeche,174921,168189,2015,2,NPS,6732,maiz
Coahuila de Zaragoza,27084,27075,2015,2,NPS,9,maiz
Colima,9634,9634,2015,2,NPS,0,maiz
Chiapas,589033,556606,2015,2,NPS,32427,maiz
Chihuahua,117152,117142,2015,2,NPS,10,maiz
Ciudad de México,3965,3965,2015,2,NPS,0,maiz
Durango,154482,150870,2015,2,NPS,3612,maiz
Guanajuato,263484,258819,2015,2,NPS,4665,maiz
Guerrero,434787,424283,2015,2,NPS,10504,maiz
Hidalgo,172752,168564,2015,2,NPS,4188,maiz
Jalisco,509104,506404,2015,2,NPS,2700,maiz
Estado de México,456481,437068,2015,2,NPS,19413,maiz
Michoacán de Ocampo,375091,352370,2015,2,D0,22721,maiz
Morelos,23341,23341,2015,2,NPS,0,maiz
Nayarit,34120,34120,2015,2,NPS,0,maiz
Nuevo León,54681,54316,2015,2,NPS,365,maiz
Oaxaca,493192,458354,2015,2,NPS,34838,maiz
Puebla,485614,459526,2015,2,NPS,26088,maiz
Querétaro de Arteaga,85219,80113,2015,2,NPS,5106,maiz
Quintana Roo,70846,47361,2015,2,NPS,23485,maiz
San Luis Potosí,215647,169684,2015,2,NPS,45963,maiz
Sinaloa,42561,40272,2015,2,NPS,2289,maiz
Sonora,1802,1802,2015,2,NPS,0,maiz
Tabasco,49802,41076,2015,2,NPS,8726,maiz
Tamaulipas,47854,28256,2015,2,NPS,19598,maiz
Tlaxcala,99068,98018,2015,2,NPS,1050,maiz
Veracruz de Ignacio de la Llave,376167,361587,2015,2,NPS,14580,maiz
Yucatán,123369,110770,2015,2,NPS,12599,maiz
Zacatecas,183647,150010,2015,2,NPS,33637,maiz
Coahuila de Zaragoza,14975,12415,2015,2,NPS,2560,maiz
Aguascalientes,33710,28013,2015,3,NPS,5697,maiz
Campeche,174921,168189,2015,3,NPS,6732,maiz
Coahuila de Zaragoza,27084,27075,2015,3,NPS,9,maiz
Colima,9634,9634,2015,3,NPS,0,maiz
Chiapas,589033,556606,2015,3,NPS,32427,maiz
Chihuahua,117152,117142,2015,3,NPS,10,maiz
Ciudad de México,3965,3965,2015,3,NPS,0,maiz
Durango,154482,150870,2015,3,NPS,3612,maiz
Guanajuato,263484,258819,2015,3,NPS,4665,maiz
Guerrero,434787,424283,2015,3,NPS,10504,maiz
Hidalgo,172752,168564,2015,3,NPS,4188,maiz
Jalisco,509104,506404,2015,3,NPS,2700,maiz
Estado de México,456481,437068,2015,3,NPS,19413,maiz
Michoacán de Ocampo,375091,352370,2015,3,NPS,22721,maiz
Morelos,23341,23341,2015,3,NPS,0,maiz
Nayarit,34120,34120,2015,3,NPS,0,maiz
Nuevo León,54681,54316,2015,3,NPS,365,maiz
Oaxaca,493192,458354,2015,3,NPS,34838,maiz
Puebla,485614,459526,2015,3,NPS,26088,maiz
Querétaro de Arteaga,85219,80113,2015,3,NPS,5106,maiz
Quintana Roo,70846,47361,2015,3,NPS,23485,maiz
San Luis Potosí,215647,169684,2015,3,NPS,45963,maiz
Sinaloa,42561,40272,2015,3,NPS,2289,maiz
Sonora,1802,1802,2015,3,NPS,0,maiz
Tabasco,49802,41076,2015,3,NPS,8726,maiz
Tamaulipas,47854,28256,2015,3,NPS,19598,maiz
Tlaxcala,99068,98018,2015,3,NPS,1050,maiz
Veracruz de Ignacio de la Llave,376167,375742,2015,3,NPS,425,maiz
Yucatán,123369,112514,2015,3,NPS,10855,maiz
Zacatecas,183647,150010,2015,3,NPS,33637,maiz
Coahuila de Zaragoza,14975,12415,2015,3,NPS,2560,maiz
Coahuila de Zaragoza,16219,117,2015,7,NPS,16102,maiz
Durango,114213,952,2015,7,NPS,113261,maiz
Coahuila de Zaragoza,4376,952,2015,7,NPS,3424,maiz
Coahuila de Zaragoza,17762,157,2015,8,NPS,17605,maiz
Durango,148840,1463,2015,8,NPS,147377,maiz
Oaxaca,482748,265,2015,8,NPS,482483,maiz
San Luis Potosí,201210,1500,2015,8,NPS,199710,maiz
Tabasco,45208,3678,2015,8,D1,41530,maiz
Veracruz de Ignacio de la Llave,335113,1958,2015,8,D0,333155,maiz
Coahuila de Zaragoza,13842,1463,2015,8,NPS,12379,maiz
Coahuila de Zaragoza,24887,1002,2015,9,NPS,23885,maiz
Durango,152169,1548,2015,9,NPS,150621,maiz
Jalisco,509531,4210,2015,9,D0,505321,maiz
Estado de México,454230,2725,2015,9,NPS,451505,maiz
Nuevo León,47136,205,2015,9,NPS,46931,maiz
Oaxaca,486478,10988,2015,9,NPS,475490,maiz
Quintana Roo,72776,4120,2015,9,D0,68656,maiz
San Luis Potosí,206240,11871,2015,9,NPS,194369,maiz
Sonora,2358,18,2015,9,NPS,2340,maiz
Tabasco,46352,6429,2015,9,D1,39923,maiz
Veracruz de Ignacio de la Llave,378758,5496,2015,9,D0,373262,maiz
Coahuila de Zaragoza,15628,1548,2015,9,NPS,14080,maiz
Aguascalientes,31744,10889,2015,10,NPS,20855,maiz
Campeche,174865,5847,2015,10,D0,169018,maiz
Coahuila de Zaragoza,24887,4608,2015,10,NPS,20279,maiz
Colima,9343,14,2015,10,NPS,9329,maiz
Chiapas,590853,11152,2015,10,D0,579701,maiz
Chihuahua,113172,12198,2015,10,NPS,100974,maiz
Durango,152169,20910,2015,10,NPS,131259,maiz
Guanajuato,250522,16055,2015,10,NPS,234467,maiz
Guerrero,437764,5015,2015,10,D0,432749,maiz
Hidalgo,165364,12565,2015,10,NPS,152799,maiz
Jalisco,514228,21721,2015,10,NPS,492507,maiz
Estado de México,454230,12370,2015,10,NPS,441860,maiz
Michoacán de Ocampo,362449,4410,2015,10,D0,358039,maiz
Nuevo León,47136,205,2015,10,NPS,46931,maiz
Oaxaca,486478,44740,2015,10,NPS,441738,maiz
Puebla,492223,97473,2015,10,NPS,394750,maiz
Querétaro de Arteaga,85855,16395,2015,10,D0,69460,maiz
Quintana Roo,72876,9410,2015,10,NPS,63466,maiz
San Luis Potosí,206240,26139,2015,10,NPS,180101,maiz
Sonora,2358,134,2015,10,NPS,2224,maiz
Tabasco,46352,14777,2015,10,D1,31575,maiz
Tamaulipas,58602,990,2015,10,NPS,57612,maiz
Tlaxcala,106302,37,2015,10,NPS,106265,maiz
Veracruz de Ignacio de la Llave,378758,31335,2015,10,D0,347423,maiz
Yucatán,107361,3071,2015,10,D0,104290,maiz
Zacatecas,181234,5505,2015,10,NPS,175729,maiz
Coahuila de Zaragoza,15628,3498,2015,10,NPS,12130,maiz
Aguascalientes,31744,23211,2015,11,NPS,8533,maiz
Campeche,174865,31495,2015,11,NPS,143370,maiz
Coahuila de Zaragoza,24887,11049,2015,11,NPS,13838,maiz
Colima,9343,3641,2015,11,NPS,5702,maiz
Chiapas,590853,106954,2015,11,NPS,483899,maiz
Chihuahua,113172,69643,2015,11,NPS,43529,maiz
Ciudad de México,3753,786,2015,11,NPS,2967,maiz
Durango,152169,56394,2015,11,NPS,95775,maiz
Guanajuato,250522,94794,2015,11,NPS,155728,maiz
Guerrero,437764,69021,2015,11,D0,368743,maiz
Hidalgo,165364,94709,2015,11,NPS,70655,maiz
Jalisco,514228,38822,2015,11,NPS,475406,maiz
Estado de México,454230,108475,2015,11,NPS,345755,maiz
Michoacán de Ocampo,362449,99820,2015,11,D0,262629,maiz
Morelos,21939,5932,2015,11,NPS,16007,maiz
Nayarit,31103,3191,2015,11,NPS,27912,maiz
Nuevo León,47136,37209,2015,11,NPS,9927,maiz
Oaxaca,486478,174522,2015,11,NPS,311956,maiz
Puebla,492223,270007,2015,11,NPS,222216,maiz
Querétaro de Arteaga,85855,53319,2015,11,NPS,32536,maiz
Quintana Roo,72876,23074,2015,11,NPS,49802,maiz
San Luis Potosí,206240,100894,2015,11,NPS,105346,maiz
Sinaloa,31017,8980,2015,11,NPS,22037,maiz
Sonora,2358,343,2015,11,NPS,2015,maiz
Tabasco,46352,33783,2015,11,D1,12569,maiz
Tamaulipas,58602,7446,2015,11,NPS,51156,maiz
Tlaxcala,106302,19176,2015,11,NPS,87126,maiz
Veracruz de Ignacio de la Llave,378758,169609,2015,11,NPS,209149,maiz
Yucatán,107361,29196,2015,11,D0,78165,maiz
Zacatecas,181234,56648,2015,11,NPS,124586,maiz
Coahuila de Zaragoza,15628,4349,2015,11,NPS,11279,maiz
Aguascalientes,31644,25325,2016,1,NPS,6319,maiz
Campeche,174865,102703,2016,1,NPS,72162,maiz
Coahuila de Zaragoza,24887,16844,2016,1,NPS,8043,maiz
Colima,9343,7960,2016,1,NPS,1383,maiz
Chiapas,590853,545973,2016,1,NPS,44880,maiz
Chihuahua,113172,109102,2016,1,NPS,4070,maiz
Ciudad de México,3753,3733,2016,1,D0,20,maiz
Durango,155135,129179,2016,1,D0,25956,maiz
Guanajuato,250522,233443,2016,1,NPS,17079,maiz
Guerrero,437764,299434,2016,1,NPS,138330,maiz
Hidalgo,165364,153641,2016,1,NPS,11723,maiz
Jalisco,505782,423540,2016,1,NPS,82242,maiz
Estado de México,454230,405269,2016,1,NPS,48961,maiz
Michoacán de Ocampo,362449,304238,2016,1,NPS,58211,maiz
Morelos,21939,21887,2016,1,NPS,52,maiz
Nayarit,31103,27898,2016,1,NPS,3205,maiz
Nuevo León,47136,47094,2016,1,D0,42,maiz
Oaxaca,486478,442043,2016,1,NPS,44435,maiz
Puebla,492223,446168,2016,1,NPS,46055,maiz
Querétaro de Arteaga,85855,81117,2016,1,D0,4738,maiz
Quintana Roo,72876,37526,2016,1,NPS,35350,maiz
San Luis Potosí,206240,142186,2016,1,NPS,64054,maiz
Sinaloa,31017,31017,2016,1,NPS,0,maiz
Sonora,2358,2358,2016,1,NPS,0,maiz
Tabasco,46352,38531,2016,1,NPS,7821,maiz
Tamaulipas,58602,33560,2016,1,NPS,25042,maiz
Tlaxcala,106302,100150,2016,1,NPS,6152,maiz
Veracruz de Ignacio de la Llave,378758,301515,2016,1,NPS,77243,maiz
Yucatán,107361,89699,2016,1,NPS,17662,maiz
Zacatecas,181234,174382,2016,1,NPS,6852,maiz
Coahuila de Zaragoza,15628,4359,2016,1,NPS,11269,maiz
Aguascalientes,31644,25325,2016,2,NPS,6319,maiz
Campeche,174865,170869,2016,2,D0,3996,maiz
Coahuila de Zaragoza,24887,16844,2016,2,NPS,8043,maiz
Colima,9343,7960,2016,2,NPS,1383,maiz
Chiapas,590853,545973,2016,2,NPS,44880,maiz
Chihuahua,113172,109102,2016,2,NPS,4070,maiz
Ciudad de México,3753,3733,2016,2,D0,20,maiz
Durango,155135,141037,2016,2,D0,14098,maiz
Guanajuato,250522,242308,2016,2,NPS,8214,maiz
Guerrero,437764,359439,2016,2,D1,78325,maiz
Hidalgo,165364,153641,2016,2,NPS,11723,maiz
Jalisco,505782,489980,2016,2,NPS,15802,maiz
Estado de México,454230,447262,2016,2,NPS,6968,maiz
Michoacán de Ocampo,362449,315868,2016,2,D0,46581,maiz
Morelos,21939,21887,2016,2,NPS,52,maiz
Nayarit,31103,29853,2016,2,NPS,1250,maiz
Nuevo León,47136,47094,2016,2,D1,42,maiz
Oaxaca,486478,444668,2016,2,NPS,41810,maiz
Puebla,492223,459100,2016,2,NPS,33123,maiz
Querétaro de Arteaga,85855,83943,2016,2,NPS,1912,maiz
Quintana Roo,72876,39436,2016,2,NPS,33440,maiz
San Luis Potosí,206240,144046,2016,2,NPS,62194,maiz
Sinaloa,31017,31017,2016,2,NPS,0,maiz
Sonora,2358,2358,2016,2,D0,0,maiz
Tabasco,46352,38531,2016,2,NPS,7821,maiz
Tamaulipas,58602,40446,2016,2,NPS,18156,maiz
Tlaxcala,106302,106302,2016,2,NPS,0,maiz
Veracruz de Ignacio de la Llave,378758,362836,2016,2,D0,15922,maiz
Yucatán,107361,95853,2016,2,D0,11508,maiz
Zacatecas,181234,174595,2016,2,NPS,6639,maiz
Coahuila de Zaragoza,15628,4359,2016,2,NPS,11269,maiz
Aguascalientes,31644,25325,2016,3,NPS,6319,maiz
Campeche,174865,170869,2016,3,NPS,3996,maiz
Coahuila de Zaragoza,24887,16844,2016,3,NPS,8043,maiz
Colima,9343,7960,2016,3,NPS,1383,maiz
Chiapas,590853,545973,2016,3,NPS,44880,maiz
Chihuahua,113172,109102,2016,3,D0,4070,maiz
Ciudad de México,3753,3733,2016,3,D0,20,maiz
Durango,155135,141037,2016,3,D0,14098,maiz
Guanajuato,250522,242308,2016,3,NPS,8214,maiz
Guerrero,437764,360537,2016,3,D1,77227,maiz
Hidalgo,165364,153641,2016,3,D0,11723,maiz
Jalisco,505782,489980,2016,3,NPS,15802,maiz
Estado de México,454230,447262,2016,3,NPS,6968,maiz
Michoacán de Ocampo,362449,315868,2016,3,D0,46581,maiz
Morelos,21939,21887,2016,3,NPS,52,maiz
Nayarit,31103,29853,2016,3,NPS,1250,maiz
Nuevo León,47136,47104,2016,3,D0,32,maiz
Oaxaca,486478,444668,2016,3,NPS,41810,maiz
Puebla,492223,459100,2016,3,NPS,33123,maiz
Querétaro de Arteaga,85855,83943,2016,3,NPS,1912,maiz
Quintana Roo,72876,39436,2016,3,NPS,33440,maiz
San Luis Potosí,206240,144046,2016,3,NPS,62194,maiz
Sinaloa,31017,31017,2016,3,NPS,0,maiz
Sonora,2358,2358,2016,3,D0,0,maiz
Tabasco,46352,38531,2016,3,NPS,7821,maiz
Tamaulipas,58602,40446,2016,3,NPS,18156,maiz
Tlaxcala,106302,106302,2016,3,NPS,0,maiz
Veracruz de Ignacio de la Llave,378758,363101,2016,3,D0,15657,maiz
Yucatán,107361,95853,2016,3,D0,11508,maiz
Zacatecas,181234,174595,2016,3,NPS,6639,maiz
Coahuila de Zaragoza,15628,4359,2016,3,NPS,11269,maiz
Coahuila de Zaragoza,16262,23,2016,7,NPS,16239,maiz
Sinaloa,1173,592,2016,7,D0,581,maiz
Coahuila de Zaragoza,18717,146,2016,8,NPS,18571,maiz
Sinaloa,18545,7901,2016,8,D0,10644,maiz
Tabasco,42038,2574,2016,8,D0,39464,maiz
Veracruz de Ignacio de la Llave,356738,2087,2016,8,NPS,354651,maiz
Coahuila de Zaragoza,24448,994,2016,9,NPS,23454,maiz
Chiapas,584471,1490,2016,9,NPS,582981,maiz
Hidalgo,165163,292,2016,9,NPS,164871,maiz
Nuevo León,47786,440,2016,9,NPS,47346,maiz
Oaxaca,472012,2570,2016,9,D0,469442,maiz
Quintana Roo,69803,2474,2016,9,D1,67329,maiz
Sinaloa,19952,7901,2016,9,NPS,12051,maiz
Sonora,2125,22,2016,9,NPS,2103,maiz
Tabasco,42690,5777,2016,9,D1,36913,maiz
Tamaulipas,69386,300,2016,9,D0,69086,maiz
Veracruz de Ignacio de la Llave,386980,5499,2016,9,NPS,381481,maiz
Yucatán,106517,6745,2016,9,D0,99772,maiz
Aguascalientes,31387,11330,2016,10,NPS,20057,maiz
Campeche,176606,1754,2016,10,D0,174852,maiz
Coahuila de Zaragoza,24516,4980,2016,10,NPS,19536,maiz
Chiapas,584471,20746,2016,10,D1,563725,maiz
Chihuahua,106068,12461,2016,10,NPS,93607,maiz
Durango,139037,177,2016,10,NPS,138860,maiz
Guanajuato,284214,17530,2016,10,NPS,266684,maiz
Guerrero,440706,3912,2016,10,D1,436794,maiz
Hidalgo,165163,10030,2016,10,NPS,155133,maiz
Jalisco,538914,11135,2016,10,NPS,527779,maiz
Estado de México,447671,1996,2016,10,NPS,445675,maiz
Michoacán de Ocampo,372488,4406,2016,10,D0,368082,maiz
Nuevo León,47806,480,2016,10,NPS,47326,maiz
Oaxaca,472012,40807,2016,10,NPS,431205,maiz
Puebla,494532,39683,2016,10,NPS,454849,maiz
Querétaro de Arteaga,84062,39423,2016,10,NPS,44639,maiz
Quintana Roo,69803,7556,2016,10,D1,62247,maiz
San Luis Potosí,158827,9731,2016,10,D0,149096,maiz
Sinaloa,19952,7930,2016,10,NPS,12022,maiz
Sonora,2125,185,2016,10,NPS,1940,maiz
Tabasco,42690,19854,2016,10,D1,22836,maiz
Tamaulipas,69386,8000,2016,10,NPS,61386,maiz
Tlaxcala,120370,1562,2016,10,NPS,118808,maiz
Veracruz de Ignacio de la Llave,386980,36525,2016,10,NPS,350455,maiz
Yucatán,106517,12590,2016,10,D1,93927,maiz
Zacatecas,165726,5920,2016,10,NPS,159806,maiz
Aguascalientes,31387,28297,2016,11,NPS,3090,maiz
Campeche,176606,25021,2016,11,D1,151585,maiz
Coahuila de Zaragoza,24516,13010,2016,11,NPS,11506,maiz
Colima,9340,3171,2016,11,D0,6169,maiz
Chiapas,584471,136584,2016,11,NPS,447887,maiz
Chihuahua,106068,76629,2016,11,NPS,29439,maiz
Ciudad de México,3629,2131,2016,11,NPS,1498,maiz
Durango,139037,62740,2016,11,NPS,76297,maiz
Guanajuato,284214,78046,2016,11,NPS,206168,maiz
Guerrero,440706,150363,2016,11,D1,290343,maiz
Hidalgo,165163,87163,2016,11,NPS,78000,maiz
Jalisco,538914,51673,2016,11,NPS,487241,maiz
Estado de México,447671,78072,2016,11,NPS,369599,maiz
Michoacán de Ocampo,372488,156954,2016,11,NPS,215534,maiz
Morelos,28208,4577,2016,11,NPS,23631,maiz
Nayarit,32285,2448,2016,11,NPS,29837,maiz
Nuevo León,47806,7481,2016,11,NPS,40325,maiz
Oaxaca,472012,181041,2016,11,NPS,290971,maiz
Puebla,494532,262367,2016,11,NPS,232165,maiz
Querétaro de Arteaga,84062,54678,2016,11,NPS,29384,maiz
Quintana Roo,69803,14682,2016,11,D1,55121,maiz
San Luis Potosí,158827,60540,2016,11,NPS,98287,maiz
Sinaloa,19952,8360,2016,11,NPS,11592,maiz
Sonora,2125,392,2016,11,NPS,1733,maiz
Tabasco,42690,39826,2016,11,D1,2864,maiz
Tamaulipas,69386,14436,2016,11,NPS,54950,maiz
Tlaxcala,120370,8981,2016,11,NPS,111389,maiz
Veracruz de Ignacio de la Llave,386980,163303,2016,11,NPS,223677,maiz
Yucatán,106517,36376,2016,11,D1,70141,maiz
Zacatecas,165440,25900,2016,11,NPS,139540,maiz
Coahuila de Zaragoza,13106,12064,2016,11,NPS,1042,maiz
Aguascalientes,31387,28980,2017,1,NPS,2407,maiz
Campeche,176606,149012,2017,1,D0,27594,maiz
Coahuila de Zaragoza,24516,24516,2017,1,NPS,0,maiz
Colima,9340,8455,2017,1,NPS,885,maiz
Chiapas,584471,569416,2017,1,NPS,15055,maiz
Chihuahua,106036,106036,2017,1,NPS,0,maiz
Ciudad de México,3629,3629,2017,1,NPS,0,maiz
Durango,138560,136065,2017,1,NPS,2495,maiz
Guanajuato,284214,272968,2017,1,NPS,11246,maiz
Guerrero,440706,414842,2017,1,D1,25864,maiz
Hidalgo,165163,161160,2017,1,NPS,4003,maiz
Jalisco,538914,469645,2017,1,NPS,69269,maiz
Estado de México,447671,444139,2017,1,NPS,3532,maiz
Michoacán de Ocampo,372488,360336,2017,1,NPS,12152,maiz
Morelos,28208,28124,2017,1,NPS,84,maiz
Nayarit,32285,28982,2017,1,NPS,3303,maiz
Nuevo León,39606,17606,2017,1,NPS,22000,maiz
Oaxaca,472012,470727,2017,1,D0,1285,maiz
Puebla,494532,484630,2017,1,NPS,9902,maiz
Querétaro de Arteaga,84062,82408,2017,1,D0,1654,maiz
Quintana Roo,69803,33539,2017,1,D1,36264,maiz
San Luis Potosí,158827,104942,2017,1,NPS,53885,maiz
Sinaloa,19952,17169,2017,1,D0,2783,maiz
Sonora,2125,2125,2017,1,D0,0,maiz
Tabasco,42690,42602,2017,1,D1,88,maiz
Tamaulipas,69386,48749,2017,1,NPS,20637,maiz
Tlaxcala,120370,97115,2017,1,NPS,23255,maiz
Veracruz de Ignacio de la Llave,386980,352483,2017,1,NPS,34497,maiz
Yucatán,106517,95428,2017,1,NPS,11089,maiz
Zacatecas,165440,158381,2017,1,NPS,7059,maiz
Coahuila de Zaragoza,13106,12098,2017,1,NPS,1008,maiz
Aguascalientes,31387,28980,2017,2,D0,2407,maiz
Campeche,176606,174610,2017,2,D0,1996,maiz
Coahuila de Zaragoza,24516,24516,2017,2,NPS,0,maiz
Colima,9340,8625,2017,2,D0,715,maiz
Chiapas,584471,584471,2017,2,NPS,0,maiz
Chihuahua,106036,106036,2017,2,NPS,0,maiz
Ciudad de México,3629,3629,2017,2,NPS,0,maiz
Durango,138560,136065,2017,2,NPS,2495,maiz
Guanajuato,284214,280718,2017,2,D0,3496,maiz
Guerrero,440706,436191,2017,2,D1,4515,maiz
Hidalgo,165163,161160,2017,2,NPS,4003,maiz
Jalisco,538914,529675,2017,2,D0,9239,maiz
Estado de México,447671,446496,2017,2,NPS,1175,maiz
Michoacán de Ocampo,372488,365887,2017,2,D0,6601,maiz
Morelos,28208,28208,2017,2,D0,0,maiz
Nayarit,32285,32285,2017,2,NPS,0,maiz
Nuevo León,39606,17606,2017,2,NPS,22000,maiz
Oaxaca,472012,471002,2017,2,D0,1010,maiz
Puebla,494532,485718,2017,2,NPS,8814,maiz
Querétaro de Arteaga,84062,84062,2017,2,D0,0,maiz
Quintana Roo,69803,53254,2017,2,NPS,16549,maiz
San Luis Potosí,158827,106737,2017,2,D0,52090,maiz
Sinaloa,19952,17169,2017,2,D0,2783,maiz
Sonora,2125,2125,2017,2,D0,0,maiz
Tabasco,42690,42602,2017,2,D2,88,maiz
Tamaulipas,69386,58827,2017,2,D0,10559,maiz
Tlaxcala,120370,120370,2017,2,NPS,0,maiz
Veracruz de Ignacio de la Llave,386980,385237,2017,2,NPS,1743,maiz
Yucatán,106517,97811,2017,2,NPS,8706,maiz
Zacatecas,165440,158996,2017,2,D0,6444,maiz
Coahuila de Zaragoza,13106,12098,2017,2,NPS,1008,maiz
Coahuila de Zaragoza,25149,49,2017,9,D0,25100,maiz
Nuevo León,52558,17,2017,9,D0,52541,maiz
Oaxaca,437431,3317,2017,9,NPS,434114,maiz
Quintana Roo,65370,2035,2017,9,NPS,63335,maiz
San Luis Potosí,204198,1985,2017,9,D0,202213,maiz
Sonora,6175,70,2017,9,NPS,6105,maiz
Tabasco,39462,10978,2017,9,D0,28484,maiz
Veracruz de Ignacio de la Llave,376430,3034,2017,9,NPS,373396,maiz
Yucatán,103751,1458,2017,9,NPS,102293,maiz
Aguascalientes,32322,1877,2017,10,NPS,30445,maiz
Campeche,163542,3311,2017,10,NPS,160231,maiz
Coahuila de Zaragoza,26364,5527,2017,10,NPS,20837,maiz
Chiapas,580956,29350,2017,10,D0,551606,maiz
Chihuahua,89986,14061,2017,10,NPS,75925,maiz
Durango,133893,128,2017,10,NPS,133765,maiz
Guanajuato,247931,18262,2017,10,NPS,229669,maiz
Guerrero,439281,5070,2017,10,NPS,434211,maiz
Hidalgo,160764,6891,2017,10,NPS,153873,maiz
Jalisco,559240,10256,2017,10,NPS,548984,maiz
Estado de México,434631,1750,2017,10,NPS,432881,maiz
Michoacán de Ocampo,355593,5588,2017,10,NPS,350005,maiz
Nuevo León,52558,87,2017,10,NPS,52471,maiz
Oaxaca,437431,37892,2017,10,NPS,399539,maiz
Puebla,470481,9546,2017,10,NPS,460935,maiz
Quintana Roo,65370,11471,2017,10,NPS,53899,maiz
San Luis Potosí,204198,17721,2017,10,NPS,186477,maiz
Sonora,6253,261,2017,10,D0,5992,maiz
Tabasco,39462,21169,2017,10,NPS,18293,maiz
Tamaulipas,53664,400,2017,10,NPS,53264,maiz
Tlaxcala,113263,1997,2017,10,NPS,111266,maiz
Veracruz de Ignacio de la Llave,382974,26967,2017,10,NPS,356007,maiz
Yucatán,103751,9001,2017,10,NPS,94750,maiz
Aguascalientes,32322,26885,2017,11,NPS,5437,maiz
Campeche,163542,25365,2017,11,NPS,138177,maiz
Coahuila de Zaragoza,26364,10788,2017,11,NPS,15576,maiz
Colima,9496,5758,2017,11,NPS,3738,maiz
Chiapas,580956,177009,2017,11,D0,403947,maiz
Chihuahua,89986,69689,2017,11,NPS,20297,maiz
Ciudad de México,3509,1486,2017,11,NPS,2023,maiz
Durango,133893,40327,2017,11,NPS,93566,maiz
Guanajuato,247931,72356,2017,11,NPS,175575,maiz
Guerrero,439281,159186,2017,11,NPS,280095,maiz
Hidalgo,160764,78154,2017,11,NPS,82610,maiz
Jalisco,559240,38336,2017,11,NPS,520904,maiz
Estado de México,434631,84636,2017,11,NPS,349995,maiz
Michoacán de Ocampo,355593,110436,2017,11,D0,245157,maiz
Morelos,30992,11688,2017,11,NPS,19304,maiz
Nayarit,29264,3624,2017,11,D0,25640,maiz
Nuevo León,52558,1089,2017,11,NPS,51469,maiz
Oaxaca,437431,178192,2017,11,NPS,259239,maiz
Puebla,470481,189062,2017,11,NPS,281419,maiz
Querétaro de Arteaga,79148,35309,2017,11,NPS,43839,maiz
Quintana Roo,65370,22063,2017,11,NPS,43307,maiz
San Luis Potosí,204198,69109,2017,11,D0,135089,maiz
Sinaloa,26103,455,2017,11,D1,25648,maiz
Sonora,6253,354,2017,11,D1,5899,maiz
Tabasco,39462,35366,2017,11,NPS,4096,maiz
Tamaulipas,53664,11669,2017,11,D0,41995,maiz
Tlaxcala,113263,5329,2017,11,NPS,107934,maiz
Veracruz de Ignacio de la Llave,382974,146773,2017,11,NPS,236201,maiz
Yucatán,103751,27433,2017,11,NPS,76318,maiz
Zacatecas,181210,47805,2017,11,NPS,133405,maiz
Aguascalientes,32322,32322,2018,1,NPS,0,maiz
Campeche,163542,135425,2018,1,NPS,28117,maiz
Coahuila de Zaragoza,26364,15326,2018,1,NPS,11038,maiz
Colima,9496,9496,2018,1,NPS,0,maiz
Chiapas,580956,555585,2018,1,D0,25371,maiz
Chihuahua,89986,89318,2018,1,NPS,668,maiz
Ciudad de México,3509,3509,2018,1,D0,0,maiz
Durango,133893,129773,2018,1,NPS,4120,maiz
Guanajuato,247931,244431,2018,1,D1,3500,maiz
Guerrero,439281,404103,2018,1,D0,35178,maiz
Hidalgo,160764,151964,2018,1,NPS,8800,maiz
Jalisco,559240,448626,2018,1,D0,110614,maiz
Estado de México,434631,431692,2018,1,D0,2939,maiz
Michoacán de Ocampo,355593,326887,2018,1,D0,28706,maiz
Morelos,30992,30415,2018,1,D0,577,maiz
Nayarit,29264,27583,2018,1,D0,1681,maiz
Nuevo León,53578,48250,2018,1,NPS,5328,maiz
Oaxaca,437431,432127,2018,1,NPS,5304,maiz
Puebla,470481,447906,2018,1,NPS,22575,maiz
Querétaro de Arteaga,79148,71361,2018,1,D1,7787,maiz
Quintana Roo,65370,60445,2018,1,NPS,4925,maiz
San Luis Potosí,204198,130764,2018,1,NPS,73434,maiz
Sinaloa,26103,18396,2018,1,D1,7707,maiz
Sonora,6253,6196,2018,1,D2,57,maiz
Tabasco,39462,39005,2018,1,NPS,457,maiz
Tamaulipas,53664,39983,2018,1,NPS,13681,maiz
Tlaxcala,113263,99572,2018,1,D0,13691,maiz
Veracruz de Ignacio de la Llave,382974,341126,2018,1,NPS,41848,maiz
Yucatán,103751,93087,2018,1,NPS,10664,maiz
Zacatecas,181210,175260,2018,1,NPS,5950,maiz
Aguascalientes,32322,32322,2018,2,NPS,0,maiz
Campeche,163542,160678,2018,2,NPS,2864,maiz
Coahuila de Zaragoza,26364,15326,2018,2,NPS,11038,maiz
Colima,9496,9496,2018,2,D0,0,maiz
Chiapas,580956,576292,2018,2,NPS,4664,maiz
Chihuahua,89986,89318,2018,2,D0,668,maiz
Ciudad de México,3509,3509,2018,2,NPS,0,maiz
Durango,133893,129773,2018,2,NPS,4120,maiz
Guanajuato,247931,246981,2018,2,D2,950,maiz
Guerrero,439281,422029,2018,2,D0,17252,maiz
Hidalgo,160764,151964,2018,2,NPS,8800,maiz
Jalisco,559240,549405,2018,2,D0,9835,maiz
Estado de México,434631,431941,2018,2,D0,2690,maiz
Michoacán de Ocampo,355593,331830,2018,2,D1,23763,maiz
Morelos,30992,30957,2018,2,D0,35,maiz
Nayarit,29264,29264,2018,2,D0,0,maiz
Nuevo León,53578,48250,2018,2,NPS,5328,maiz
Oaxaca,437431,432775,2018,2,NPS,4656,maiz
Puebla,470481,459929,2018,2,NPS,10552,maiz
Querétaro de Arteaga,79148,79058,2018,2,D1,90,maiz
Quintana Roo,65370,62785,2018,2,NPS,2585,maiz
San Luis Potosí,204198,133527,2018,2,D0,70671,maiz
Sinaloa,26103,23578,2018,2,D1,2525,maiz
Sonora,6253,6196,2018,2,D2,57,maiz
Tabasco,39462,39005,2018,2,NPS,457,maiz
Tamaulipas,53664,42751,2018,2,NPS,10913,maiz
Tlaxcala,113263,111294,2018,2,D0,1969,maiz
Veracruz de Ignacio de la Llave,382974,348817,2018,2,NPS,34157,maiz
Yucatán,103751,101834,2018,2,NPS,1917,maiz
Zacatecas,181210,175260,2018,2,NPS,5950,maiz
Tabasco,46916,1999,2018,8,D2,44917,maiz
Coahuila de Zaragoza,25709,184,2018,9,NPS,25525,maiz
Guerrero,434801,885,2018,9,D1,433916,maiz
Hidalgo,145831,101,2018,9,D0,145730,maiz
Oaxaca,434544,6898,2018,9,D0,427646,maiz
Quintana Roo,62658,3385,2018,9,D0,59273,maiz
Sonora,1530,123,2018,9,NPS,1407,maiz
Tabasco,46920,9796,2018,9,D3,37124,maiz
Veracruz de Ignacio de la Llave,370268,4829,2018,9,D1,365439,maiz
Yucatán,104690,842,2018,9,NPS,103848,maiz
Aguascalientes,32330,3440,2018,10,NPS,28890,maiz
Campeche,163769,11466,2018,10,NPS,152303,maiz
Coahuila de Zaragoza,25834,4141,2018,10,NPS,21693,maiz
Chiapas,552194,23790,2018,10,D0,528404,maiz
Chihuahua,81454,10110,2018,10,NPS,71344,maiz
Guerrero,434801,7012,2018,10,D1,427789,maiz
Hidalgo,145831,8703,2018,10,D1,137128,maiz
Jalisco,531147,8975,2018,10,NPS,522172,maiz
Estado de México,425981,52,2018,10,NPS,425929,maiz
Michoacán de Ocampo,338615,4305,2018,10,NPS,334310,maiz
Nuevo León,53387,14670,2018,10,NPS,38717,maiz
Oaxaca,434544,41361,2018,10,NPS,393183,maiz
Puebla,453692,17962,2018,10,NPS,435730,maiz
Quintana Roo,62658,14836,2018,10,D0,47822,maiz
San Luis Potosí,177759,9776,2018,10,NPS,167983,maiz
Sonora,1530,272,2018,10,NPS,1258,maiz
Tabasco,46920,25264,2018,10,D3,21656,maiz
Tlaxcala,119467,1022,2018,10,NPS,118445,maiz
Veracruz de Ignacio de la Llave,370268,23559,2018,10,D1,346709,maiz
Yucatán,104690,6525,2018,10,D0,98165,maiz
Zacatecas,170764,1281,2018,10,NPS,169483,maiz
Aguascalientes,32330,32129,2018,11,NPS,201,maiz
Campeche,163769,25204,2018,11,D1,138565,maiz
Coahuila de Zaragoza,25834,17177,2018,11,NPS,8657,maiz
Colima,10777,6875,2018,11,NPS,3902,maiz
Chiapas,552194,188979,2018,11,D0,363215,maiz
Chihuahua,81454,57282,2018,11,NPS,24172,maiz
Ciudad de México,3575,1576,2018,11,NPS,1999,maiz
Durango,117706,52425,2018,11,NPS,65281,maiz
Guanajuato,260009,51098,2018,11,NPS,208911,maiz
Guerrero,434801,156712,2018,11,D0,278089,maiz
Hidalgo,145831,131422,2018,11,D1,14409,maiz
Jalisco,531147,41813,2018,11,NPS,489334,maiz
Estado de México,425981,95377,2018,11,NPS,330604,maiz
Michoacán de Ocampo,338615,102547,2018,11,NPS,236068,maiz
Morelos,35344,10534,2018,11,NPS,24810,maiz
Nayarit,24798,3415,2018,11,NPS,21383,maiz
Nuevo León,53387,28995,2018,11,NPS,24392,maiz
Oaxaca,434544,177561,2018,11,NPS,256983,maiz
Puebla,453692,180291,2018,11,NPS,273401,maiz
Querétaro de Arteaga,77276,18079,2018,11,D1,59197,maiz
Quintana Roo,62658,38729,2018,11,D1,23929,maiz
San Luis Potosí,177759,53439,2018,11,NPS,124320,maiz
Sinaloa,23877,8147,2018,11,NPS,15730,maiz
Sonora,1530,515,2018,11,NPS,1015,maiz
Tabasco,46920,41655,2018,11,D2,5265,maiz
Tamaulipas,38796,7366,2018,11,NPS,31430,maiz
Tlaxcala,119467,10565,2018,11,NPS,108902,maiz
Veracruz de Ignacio de la Llave,370268,142637,2018,11,NPS,227631,maiz
Yucatán,104690,25439,2018,11,D0,79251,maiz
Zacatecas,170764,45093,2018,11,NPS,125671,maiz
Aguascalientes,32330,32129,2019,1,NPS,201,maiz
Campeche,163769,138698,2019,1,D0,25071,maiz
Coahuila de Zaragoza,25834,25794,2019,1,NPS,40,maiz
Colima,10777,10777,2019,1,NPS,0,maiz
Chiapas,552194,487116,2019,1,D0,65078,maiz
Chihuahua,81454,81389,2019,1,NPS,65,maiz
Ciudad de México,3575,3575,2019,1,NPS,0,maiz
Durango,117706,107592,2019,1,NPS,10114,maiz
Guanajuato,260009,255213,2019,1,NPS,4796,maiz
Guerrero,434801,420644,2019,1,NPS,14157,maiz
Hidalgo,145831,135627,2019,1,D1,10204,maiz
Jalisco,531147,464020,2019,1,NPS,67127,maiz
Estado de México,425981,420025,2019,1,NPS,5956,maiz
Michoacán de Ocampo,338615,313151,2019,1,NPS,25464,maiz
Morelos,35344,29976,2019,1,NPS,5368,maiz
Nayarit,24798,21253,2019,1,NPS,3545,maiz
Nuevo León,53387,53017,2019,1,NPS,370,maiz
Oaxaca,434544,412063,2019,1,NPS,22481,maiz
Puebla,453692,429849,2019,1,NPS,23843,maiz
Querétaro de Arteaga,77276,73894,2019,1,NPS,3382,maiz
Quintana Roo,62658,56561,2019,1,NPS,6097,maiz
San Luis Potosí,177759,86282,2019,1,D0,91477,maiz
Sinaloa,23877,16561,2019,1,D0,7316,maiz
Sonora,1530,1019,2019,1,NPS,511,maiz
Tabasco,46920,46096,2019,1,D2,824,maiz
Tamaulipas,38796,15501,2019,1,D0,23295,maiz
Tlaxcala,119467,112022,2019,1,NPS,7445,maiz
Veracruz de Ignacio de la Llave,370268,342115,2019,1,NPS,28153,maiz
Yucatán,104690,95976,2019,1,D1,8714,maiz
Zacatecas,170764,159414,2019,1,NPS,11350,maiz
Aguascalientes,32330,32330,2019,2,NPS,0,maiz
Campeche,163769,161174,2019,2,D1,2595,maiz
Coahuila de Zaragoza,25834,25794,2019,2,NPS,40,maiz
Colima,10777,10777,2019,2,D0,0,maiz
Chiapas,552194,537650,2019,2,D0,14544,maiz
Chihuahua,81454,81389,2019,2,NPS,65,maiz
Ciudad de México,3575,3575,2019,2,NPS,0,maiz
Durango,117706,107592,2019,2,D0,10114,maiz
Guanajuato,260009,257878,2019,2,NPS,2131,maiz
Guerrero,434801,425190,2019,2,NPS,9611,maiz
Hidalgo,145831,135627,2019,2,D1,10204,maiz
Jalisco,531147,530344,2019,2,NPS,803,maiz
Estado de México,425981,423270,2019,2,NPS,2711,maiz
Michoacán de Ocampo,338615,326870,2019,2,NPS,11745,maiz
Morelos,35344,35344,2019,2,NPS,0,maiz
Nayarit,24798,22997,2019,2,D0,1801,maiz
Nuevo León,53387,53017,2019,2,NPS,370,maiz
Oaxaca,434544,420434,2019,2,NPS,14110,maiz
Puebla,453692,450814,2019,2,D0,2878,maiz
Querétaro de Arteaga,77276,74064,2019,2,D0,3212,maiz
Quintana Roo,62658,60140,2019,2,NPS,2518,maiz
San Luis Potosí,177759,86509,2019,2,D0,91250,maiz
Sinaloa,23877,23232,2019,2,D0,645,maiz
Sonora,1530,1530,2019,2,NPS,0,maiz
Tabasco,46920,46096,2019,2,D2,824,maiz
Tamaulipas,38796,18568,2019,2,D1,20228,maiz
Tlaxcala,119467,119037,2019,2,NPS,430,maiz
Veracruz de Ignacio de la Llave,370268,345469,2019,2,D0,24799,maiz
Yucatán,104690,102377,2019,2,D0,2313,maiz
Zacatecas,170764,168392,2019,2,NPS,2372,maiz
Sinaloa,11275,3443,2019,8,D1,7832,maiz
Tabasco,45701,1372,2019,8,D3,44329,maiz
Veracruz de Ignacio de la Llave,363206,288,2019,8,D2,362918,maiz
Coahuila de Zaragoza,15311,138,2019,9,NPS,15173,maiz
Hidalgo,152207,89,2019,9,D0,152118,maiz
Nuevo León,56750,106,2019,9,NPS,56644,maiz
Oaxaca,418094,6936,2019,9,D0,411158,maiz
Quintana Roo,51441,419,2019,9,D1,51022,maiz
Sinaloa,33069,3443,2019,9,D0,29626,maiz
Tabasco,46621,9704,2019,9,D3,36917,maiz
Veracruz de Ignacio de la Llave,369075,6977,2019,9,D3,362098,maiz
Yucatán,102900,3,2019,9,D0,102897,maiz
Aguascalientes,24783,2213,2019,10,D1,22570,maiz
Campeche,160076,11705,2019,10,NPS,148371,maiz
Coahuila de Zaragoza,15311,3825,2019,10,D0,11486,maiz
Chiapas,579235,22971,2019,10,D1,556264,maiz
Chihuahua,84151,5555,2019,10,NPS,78596,maiz
Durango,88444,82,2019,10,D1,88362,maiz
Guerrero,443138,4833,2019,10,NPS,438305,maiz
Hidalgo,152207,9764,2019,10,D0,142443,maiz
Jalisco,547895,5130,2019,10,D0,542765,maiz
Michoacán de Ocampo,318886,3754,2019,10,D1,315132,maiz
Nuevo León,56750,343,2019,10,NPS,56407,maiz
Oaxaca,418094,55063,2019,10,NPS,363031,maiz
Puebla,467457,4330,2019,10,NPS,463127,maiz
Quintana Roo,51441,4328,2019,10,D1,47113,maiz
San Luis Potosí,91616,5982,2019,10,D3,85634,maiz
Sinaloa,33069,5297,2019,10,D0,27772,maiz
Sonora,2892,241,2019,10,NPS,2651,maiz
Tabasco,46621,25140,2019,10,D3,21481,maiz
Tlaxcala,87044,934,2019,10,NPS,86110,maiz
Veracruz de Ignacio de la Llave,369075,39369,2019,10,D3,329706,maiz
Yucatán,102900,70,2019,10,D0,102830,maiz
Aguascalientes,24783,12117,2019,11,NPS,12666,maiz
Campeche,160076,21365,2019,11,NPS,138711,maiz
Coahuila de Zaragoza,15311,8450,2019,11,NPS,6861,maiz
Colima,10070,7873,2019,11,NPS,2197,maiz
Chiapas,579235,174752,2019,11,D0,404483,maiz
Chihuahua,84151,58687,2019,11,NPS,25464,maiz
Ciudad de México,3484,1831,2019,11,NPS,1653,maiz
Durango,88444,35262,2019,11,D0,53182,maiz
Guanajuato,251284,27038,2019,11,D0,224246,maiz
Guerrero,443138,125566,2019,11,NPS,317572,maiz
Hidalgo,152207,101055,2019,11,D0,51152,maiz
Jalisco,547895,55021,2019,11,NPS,492874,maiz
Estado de México,394431,55978,2019,11,NPS,338453,maiz
Michoacán de Ocampo,318886,73154,2019,11,D0,245732,maiz
Morelos,34063,9654,2019,11,NPS,24409,maiz
Nayarit,20746,370,2019,11,D0,20376,maiz
Nuevo León,56750,39087,2019,11,NPS,17663,maiz
Oaxaca,418094,176577,2019,11,NPS,241517,maiz
Puebla,467457,152959,2019,11,NPS,314498,maiz
Querétaro de Arteaga,66321,24500,2019,11,D1,41821,maiz
Quintana Roo,51441,12224,2019,11,NPS,39217,maiz
San Luis Potosí,91616,13188,2019,11,D1,78428,maiz
Sinaloa,33069,11612,2019,11,NPS,21457,maiz
Sonora,2892,353,2019,11,NPS,2539,maiz
Tabasco,46621,40684,2019,11,D1,5937,maiz
Tamaulipas,24378,1896,2019,11,D1,22482,maiz
Tlaxcala,87044,4781,2019,11,NPS,82263,maiz
Veracruz de Ignacio de la Llave,369075,156298,2019,11,D2,212777,maiz
Yucatán,102900,9180,2019,11,NPS,93720,maiz
Zacatecas,116231,19604,2019,11,NPS,96627,maiz
Aguascalientes,24783,13276,2020,1,NPS,11507,maiz
Campeche,160076,150231,2020,1,NPS,9845,maiz
Coahuila de Zaragoza,15311,10450,2020,1,NPS,4861,maiz
Colima,10070,10070,2020,1,NPS,0,maiz
Chiapas,579235,507058,2020,1,D0,72177,maiz
Chihuahua,84151,84082,2020,1,NPS,69,maiz
Ciudad de México,3484,3404,2020,1,NPS,80,maiz
Durango,88444,85792,2020,1,NPS,2652,maiz
Guanajuato,251284,233967,2020,1,D0,17317,maiz
Guerrero,443138,375167,2020,1,NPS,67971,maiz
Hidalgo,152207,113039,2020,1,D0,39168,maiz
Jalisco,547895,406824,2020,1,NPS,141071,maiz
Estado de México,394431,363651,2020,1,NPS,30780,maiz
Michoacán de Ocampo,318886,290256,2020,1,D1,28630,maiz
Morelos,34063,32741,2020,1,NPS,1322,maiz
Nayarit,20746,16678,2020,1,NPS,4068,maiz
Nuevo León,56750,56610,2020,1,D0,140,maiz
Oaxaca,418094,374314,2020,1,NPS,43780,maiz
Puebla,467457,445992,2020,1,NPS,21465,maiz
Querétaro de Arteaga,66321,40881,2020,1,D1,25440,maiz
Quintana Roo,51441,28576,2020,1,NPS,22865,maiz
San Luis Potosí,91616,21847,2020,1,D3,69769,maiz
Sinaloa,33069,30538,2020,1,NPS,2531,maiz
Sonora,2892,2012,2020,1,NPS,880,maiz
Tabasco,46621,43748,2020,1,D1,2873,maiz
Tamaulipas,24378,8684,2020,1,D1,15694,maiz
Tlaxcala,87044,84868,2020,1,NPS,2176,maiz
Veracruz de Ignacio de la Llave,369075,287862,2020,1,D1,81213,maiz
Yucatán,102900,65132,2020,1,NPS,37768,maiz
Zacatecas,116231,60932,2020,1,NPS,55299,maiz
Aguascalientes,24783,13276,2020,2,NPS,11507,maiz
Campeche,160076,154474,2020,2,D0,5602,maiz
Coahuila de Zaragoza,15311,10450,2020,2,D0,4861,maiz
Colima,10070,10070,2020,2,NPS,0,maiz
Chiapas,579235,546719,2020,2,D0,32516,maiz
Chihuahua,84151,84082,2020,2,NPS,69,maiz
Ciudad de México,3484,3404,2020,2,NPS,80,maiz
Durango,88444,85792,2020,2,NPS,2652,maiz
Guanajuato,251284,234269,2020,2,NPS,17015,maiz
Guerrero,443138,394842,2020,2,NPS,48296,maiz
Hidalgo,152207,113039,2020,2,D0,39168,maiz
Jalisco,547895,505547,2020,2,NPS,42348,maiz
Estado de México,394431,387263,2020,2,NPS,7168,maiz
Michoacán de Ocampo,318886,298684,2020,2,D0,20202,maiz
Morelos,34063,34063,2020,2,NPS,0,maiz
Nayarit,20746,18901,2020,2,NPS,1845,maiz
Nuevo León,56750,56610,2020,2,D0,140,maiz
Oaxaca,418094,383754,2020,2,NPS,34340,maiz
Puebla,467457,452314,2020,2,NPS,15143,maiz
Querétaro de Arteaga,66321,43434,2020,2,D0,22887,maiz
Quintana Roo,51441,28576,2020,2,D0,22865,maiz
San Luis Potosí,91616,22134,2020,2,D3,69482,maiz
Sinaloa,33069,32555,2020,2,NPS,514,maiz
Sonora,2892,2890,2020,2,NPS,2,maiz
Tabasco,46621,43748,2020,2,D1,2873,maiz
Tamaulipas,24378,10241,2020,2,D1,14137,maiz
Tlaxcala,87044,86791,2020,2,NPS,253,maiz
Veracruz de Ignacio de la Llave,369075,313715,2020,2,NPS,55360,maiz
Yucatán,102900,93068,2020,2,D0,9832,maiz
Zacatecas,116231,60932,2020,2,NPS,55299,maiz
Sinaloa,17788,3702,2020,8,D1,14086,maiz
Tabasco,50137,1520,2020,8,NPS,48617,maiz
Veracruz de Ignacio de la Llave,383430,6595,2020,8,NPS,376835,maiz
Coahuila de Zaragoza,21536,90,2020,9,D0,21446,maiz
Hidalgo,147454,75,2020,9,D0,147379,maiz
Nuevo León,54777,90,2020,9,NPS,54687,maiz
Oaxaca,431647,8062,2020,9,NPS,423585,maiz
Quintana Roo,53316,11232,2020,9,D0,42084,maiz
San Luis Potosí,201018,250,2020,9,D1,200768,maiz
Sinaloa,30215,9109,2020,9,D1,21106,maiz
Tabasco,50528,11716,2020,9,NPS,38812,maiz
Veracruz de Ignacio de la Llave,387235,10822,2020,9,D0,376413,maiz
Aguascalientes,32713,795,2020,10,D0,31918,maiz
Coahuila de Zaragoza,21536,5405,2020,10,D0,16131,maiz
Chiapas,578216,23080,2020,10,NPS,555136,maiz
Chihuahua,78384,2380,2020,10,D1,76004,maiz
Durango,117965,154,2020,10,D1,117811,maiz
Guerrero,448881,5792,2020,10,D2,443089,maiz
Hidalgo,147454,1620,2020,10,D0,145834,maiz
Jalisco,549166,5287,2020,10,D1,543879,maiz
Michoacán de Ocampo,340317,6681,2020,10,D1,333636,maiz
Nuevo León,54777,117,2020,10,NPS,54660,maiz
Oaxaca,431647,56942,2020,10,NPS,374705,maiz
Puebla,454863,39239,2020,10,NPS,415624,maiz
Querétaro de Arteaga,73522,10570,2020,10,D0,62952,maiz
Quintana Roo,53316,18972,2020,10,NPS,34344,maiz
San Luis Potosí,201018,33910,2020,10,D1,167108,maiz
Sinaloa,30215,11432,2020,10,D1,18783,maiz
Sonora,1639,203,2020,10,D2,1436,maiz
Tabasco,50528,27489,2020,10,NPS,23039,maiz
Veracruz de Ignacio de la Llave,387235,37752,2020,10,D0,349483,maiz
Aguascalientes,32713,31139,2020,11,D0,1574,maiz
Campeche,171482,20473,2020,11,NPS,151009,maiz
Coahuila de Zaragoza,21536,14992,2020,11,D0,6544,maiz
Colima,8949,6765,2020,11,D0,2184,maiz
Chiapas,578216,181522,2020,11,NPS,396694,maiz
Chihuahua,78384,36053,2020,11,D2,42331,maiz
Ciudad de México,3414,2025,2020,11,NPS,1389,maiz
Durango,117965,45558,2020,11,D0,72407,maiz
Guanajuato,273925,7166,2020,11,D1,266759,maiz
Guerrero,448881,135610,2020,11,D2,313271,maiz
Hidalgo,147454,46474,2020,11,D0,100980,maiz
Jalisco,549166,49777,2020,11,D1,499389,maiz
Estado de México,417580,71078,2020,11,D0,346502,maiz
Michoacán de Ocampo,340317,86763,2020,11,D1,253554,maiz
Morelos,35679,9847,2020,11,NPS,25832,maiz
Nayarit,21807,2571,2020,11,D1,19236,maiz
Nuevo León,54777,48628,2020,11,D0,6149,maiz
Oaxaca,431647,174769,2020,11,NPS,256878,maiz
Puebla,454863,162006,2020,11,NPS,292857,maiz
Querétaro de Arteaga,73522,30162,2020,11,D1,43360,maiz
Quintana Roo,53316,22347,2020,11,NPS,30969,maiz
San Luis Potosí,201018,82235,2020,11,D1,118783,maiz
Sinaloa,30215,11432,2020,11,D2,18783,maiz
Sonora,1639,207,2020,11,D2,1432,maiz
Tabasco,50528,37671,2020,11,NPS,12857,maiz
Tamaulipas,64280,14005,2020,11,D1,50275,maiz
Tlaxcala,112177,4459,2020,11,NPS,107718,maiz
Veracruz de Ignacio de la Llave,387235,113143,2020,11,D0,274092,maiz
Yucatán,101047,6732,2020,11,NPS,94315,maiz
Zacatecas,174370,72067,2020,11,D0,102303,maiz
Chiapas,44690,2890,2004,1,NPS,41800,frijol
Hidalgo,4512,3516,2004,1,NPS,996,frijol
Veracruz de Ignacio de la Llave,16350,2504,2004,1,NPS,13846,frijol
Yucatán,440,0,2004,1,D0,440,frijol
Chiapas,45121,10151,2004,2,NPS,34970,frijol
Hidalgo,4894,4094,2004,2,NPS,800,frijol
Nayarit,46027,9000,2004,2,NPS,37027,frijol
Oaxaca,3403,675,2004,2,NPS,2728,frijol
Quintana Roo,3638,2814,2004,2,NPS,824,frijol
San Luis Potosí,1476,615,2004,2,NPS,861,frijol
Sinaloa,16092,3931,2004,2,NPS,12161,frijol
Tabasco,6401,185,2004,2,NPS,6216,frijol
Tamaulipas,1084,170,2004,2,NPS,914,frijol
Veracruz de Ignacio de la Llave,21347,5094,2004,2,NPS,16253,frijol
Yucatán,488,91,2004,2,NPS,397,frijol
Campeche,3488,2278,2004,3,NPS,1210,frijol
Chiapas,46239,33140,2004,3,NPS,13099,frijol
Guerrero,62,46,2004,3,NPS,16,frijol
Hidalgo,5004,4294,2004,3,NPS,710,frijol
Jalisco,2272,2024,2004,3,NPS,248,frijol
Nayarit,46236,44466,2004,3,NPS,1770,frijol
Oaxaca,3608,940,2004,3,NPS,2668,frijol
Quintana Roo,3638,3500,2004,3,NPS,138,frijol
San Luis Potosí,1476,1101,2004,3,NPS,375,frijol
Sinaloa,16406,14773,2004,3,NPS,1633,frijol
Tabasco,6401,3051,2004,3,NPS,3350,frijol
Tamaulipas,1302,690,2004,3,NPS,612,frijol
Veracruz de Ignacio de la Llave,22352,9756,2004,3,NPS,12596,frijol
Yucatán,488,212,2004,3,D0,276,frijol
Campeche,3488,3488,2004,4,NPS,0,frijol
Chiapas,46364,38326,2004,4,NPS,8038,frijol
Guerrero,62,61,2004,4,NPS,1,frijol
Hidalgo,5004,4604,2004,4,NPS,400,frijol
Jalisco,2272,2169,2004,4,NPS,103,frijol
Nayarit,46236,44484,2004,4,NPS,1752,frijol
Oaxaca,3608,2719,2004,4,NPS,889,frijol
Quintana Roo,3638,3506,2004,4,NPS,132,frijol
San Luis Potosí,1476,1412,2004,4,NPS,64,frijol
Sinaloa,16406,14853,2004,4,NPS,1553,frijol
Tabasco,6401,5084,2004,4,NPS,1317,frijol
Tamaulipas,1358,753,2004,4,NPS,605,frijol
Veracruz de Ignacio de la Llave,22352,17830,2004,4,NPS,4522,frijol
Yucatán,488,436,2004,4,NPS,52,frijol
Campeche,3488,3488,2004,5,NPS,0,frijol
Chiapas,46364,39274,2004,5,NPS,7090,frijol
Guerrero,62,62,2004,5,NPS,0,frijol
Hidalgo,5004,4809,2004,5,NPS,195,frijol
Jalisco,2272,2169,2004,5,NPS,103,frijol
Nayarit,46236,44484,2004,5,D0,1752,frijol
Oaxaca,3608,3318,2004,5,NPS,290,frijol
Quintana Roo,3638,3506,2004,5,NPS,132,frijol
San Luis Potosí,1476,1412,2004,5,NPS,64,frijol
Sinaloa,16406,14853,2004,5,NPS,1553,frijol
Tabasco,6401,6181,2004,5,NPS,220,frijol
Tamaulipas,1392,879,2004,5,NPS,513,frijol
Veracruz de Ignacio de la Llave,22518,20528,2004,5,NPS,1990,frijol
Yucatán,488,456,2004,5,NPS,32,frijol
Campeche,3488,3488,2004,6,D0,0,frijol
Chiapas,46364,40682,2004,6,NPS,5682,frijol
Guerrero,62,62,2004,6,NPS,0,frijol
Hidalgo,5004,5004,2004,6,NPS,0,frijol
Jalisco,2272,2272,2004,6,NPS,0,frijol
Michoacán de Ocampo,31,1,2004,6,NPS,30,frijol
Nayarit,46236,44484,2004,6,D0,1752,frijol
Oaxaca,3608,3608,2004,6,NPS,0,frijol
Puebla,378,350,2004,6,NPS,28,frijol
Quintana Roo,3638,3506,2004,6,NPS,132,frijol
San Luis Potosí,1476,1412,2004,6,NPS,64,frijol
Sinaloa,16406,14853,2004,6,NPS,1553,frijol
Tabasco,6401,6181,2004,6,D0,220,frijol
Tamaulipas,1392,1022,2004,6,NPS,370,frijol
Veracruz de Ignacio de la Llave,22518,21331,2004,6,NPS,1187,frijol
Yucatán,488,456,2004,6,D0,32,frijol
Campeche,3488,3488,2004,7,NPS,0,frijol
Chiapas,46364,46364,2004,7,NPS,0,frijol
Guerrero,62,62,2004,7,NPS,0,frijol
Hidalgo,5004,5004,2004,7,NPS,0,frijol
Jalisco,2272,2272,2004,7,NPS,0,frijol
Michoacán de Ocampo,31,1,2004,7,NPS,30,frijol
Nayarit,46236,44484,2004,7,NPS,1752,frijol
Oaxaca,3608,3608,2004,7,NPS,0,frijol
Puebla,378,378,2004,7,NPS,0,frijol
Quintana Roo,3638,3510,2004,7,D0,128,frijol
San Luis Potosí,1476,1412,2004,7,NPS,64,frijol
Sinaloa,16406,14853,2004,7,NPS,1553,frijol
Tabasco,6401,6181,2004,7,D0,220,frijol
Tamaulipas,1392,1158,2004,7,NPS,234,frijol
Veracruz de Ignacio de la Llave,22523,21336,2004,7,NPS,1187,frijol
Yucatán,488,456,2004,7,NPS,32,frijol
Campeche,3488,3488,2004,8,D0,0,frijol
Chiapas,46364,46364,2004,8,D0,0,frijol
Guerrero,62,62,2004,8,NPS,0,frijol
Hidalgo,5004,5004,2004,8,NPS,0,frijol
Jalisco,2272,2272,2004,8,NPS,0,frijol
Michoacán de Ocampo,31,1,2004,8,NPS,30,frijol
Nayarit,46236,44484,2004,8,D0,1752,frijol
Oaxaca,3608,3608,2004,8,NPS,0,frijol
Puebla,378,378,2004,8,NPS,0,frijol
Quintana Roo,3638,3510,2004,8,D0,128,frijol
San Luis Potosí,1476,1412,2004,8,NPS,64,frijol
Sinaloa,16406,14853,2004,8,NPS,1553,frijol
Tabasco,6401,6181,2004,8,D0,220,frijol
Tamaulipas,1392,1300,2004,8,NPS,92,frijol
Veracruz de Ignacio de la Llave,22523,21745,2004,8,D0,778,frijol
Yucatán,488,456,2004,8,NPS,32,frijol
Campeche,3488,3488,2004,9,D0,0,frijol
Chiapas,46364,46364,2004,9,D1,0,frijol
Guerrero,62,62,2004,9,NPS,0,frijol
Hidalgo,5004,5004,2004,9,NPS,0,frijol
Jalisco,2272,2272,2004,9,NPS,0,frijol
Michoacán de Ocampo,31,31,2004,9,NPS,0,frijol
Nayarit,46236,44484,2004,9,D0,1752,frijol
Nuevo León,9,9,2004,9,NPS,0,frijol
Oaxaca,3608,3608,2004,9,D1,0,frijol
Puebla,378,378,2004,9,NPS,0,frijol
Quintana Roo,3638,3510,2004,9,D1,128,frijol
San Luis Potosí,1476,1412,2004,9,NPS,64,frijol
Sinaloa,16406,14853,2004,9,NPS,1553,frijol
Tabasco,6401,6181,2004,9,D1,220,frijol
Tamaulipas,1392,1312,2004,9,NPS,80,frijol
Veracruz de Ignacio de la Llave,22523,21976,2004,9,D0,547,frijol
Yucatán,488,456,2004,9,D0,32,frijol
Campeche,3488,3488,2004,12,D0,0,frijol
Chiapas,46364,46364,2004,12,D1,0,frijol
Guerrero,62,62,2004,12,NPS,0,frijol
Hidalgo,5004,5004,2004,12,NPS,0,frijol
Jalisco,2272,2272,2004,12,NPS,0,frijol
Michoacán de Ocampo,31,31,2004,12,NPS,0,frijol
Nayarit,46236,44484,2004,12,NPS,1752,frijol
Nuevo León,9,9,2004,12,NPS,0,frijol
Oaxaca,3608,3608,2004,12,D0,0,frijol
Puebla,378,378,2004,12,NPS,0,frijol
Quintana Roo,3638,3510,2004,12,D1,128,frijol
San Luis Potosí,1476,1412,2004,12,NPS,64,frijol
Sinaloa,16406,14853,2004,12,NPS,1553,frijol
Tabasco,6401,6181,2004,12,D1,220,frijol
Tamaulipas,1392,1312,2004,12,NPS,80,frijol
Veracruz de Ignacio de la Llave,22523,21976,2004,12,D0,547,frijol
Yucatán,488,456,2004,12,NPS,32,frijol
Chiapas,43173,2350,2005,1,D1,40823,frijol
Hidalgo,4676,3951,2005,1,D0,725,frijol
Quintana Roo,2841,1486,2005,1,D1,1355,frijol
Sinaloa,10264,800,2005,1,NPS,9464,frijol
Veracruz de Ignacio de la Llave,21086,2662,2005,1,D1,18424,frijol
Yucatán,901,40,2005,1,D0,861,frijol
Campeche,2876,345,2005,2,D1,2531,frijol
Chiapas,43947,7879,2005,2,D1,36068,frijol
Hidalgo,4861,3951,2005,2,NPS,910,frijol
Nayarit,40288,10447,2005,2,NPS,29841,frijol
Oaxaca,3324,48,2005,2,D0,3276,frijol
Quintana Roo,2841,1831,2005,2,D1,1010,frijol
Sinaloa,10266,5360,2005,2,NPS,4906,frijol
Tabasco,6032,452,2005,2,D2,5580,frijol
Veracruz de Ignacio de la Llave,23331,10967,2005,2,D1,12364,frijol
Yucatán,901,102,2005,2,D0,799,frijol
Campeche,2876,695,2005,3,D1,2181,frijol
Chiapas,43947,22233,2005,3,D1,21714,frijol
Guerrero,88,2,2005,3,NPS,86,frijol
Hidalgo,4861,4176,2005,3,NPS,685,frijol
Jalisco,1895,1598,2005,3,NPS,297,frijol
Nayarit,40533,32165,2005,3,NPS,8368,frijol
Oaxaca,3375,1548,2005,3,NPS,1827,frijol
Quintana Roo,2817,2218,2005,3,D1,599,frijol
San Luis Potosí,840,388,2005,3,NPS,452,frijol
Sinaloa,10298,9566,2005,3,NPS,732,frijol
Tabasco,6032,452,2005,3,D2,5580,frijol
Veracruz de Ignacio de la Llave,23840,15155,2005,3,D1,8685,frijol
Yucatán,901,857,2005,3,D0,44,frijol
Campeche,2926,1466,2005,4,D1,1460,frijol
Chiapas,45405,31311,2005,4,D1,14094,frijol
Guerrero,88,68,2005,4,NPS,20,frijol
Hidalgo,4861,4306,2005,4,NPS,555,frijol
Jalisco,1896,1708,2005,4,NPS,188,frijol
Nayarit,40533,32220,2005,4,NPS,8313,frijol
Oaxaca,3375,3119,2005,4,D0,256,frijol
Quintana Roo,2845,2238,2005,4,D1,607,frijol
San Luis Potosí,840,741,2005,4,NPS,99,frijol
Sinaloa,10298,9740,2005,4,NPS,558,frijol
Tabasco,6032,3030,2005,4,D2,3002,frijol
Veracruz de Ignacio de la Llave,23840,17132,2005,4,D1,6708,frijol
Yucatán,901,867,2005,4,D0,34,frijol
Baja California,4,2,2005,5,NPS,2,frijol
Campeche,2926,1539,2005,5,D0,1387,frijol
Chiapas,45405,31519,2005,5,D1,13886,frijol
Chihuahua,195,78,2005,5,NPS,117,frijol
Guerrero,88,68,2005,5,NPS,20,frijol
Hidalgo,4861,4371,2005,5,NPS,490,frijol
Jalisco,1896,1861,2005,5,D0,35,frijol
Nayarit,40533,32220,2005,5,NPS,8313,frijol
Oaxaca,3375,3145,2005,5,NPS,230,frijol
Puebla,2546,14,2005,5,NPS,2532,frijol
Quintana Roo,2845,2246,2005,5,D1,599,frijol
San Luis Potosí,840,741,2005,5,NPS,99,frijol
Sinaloa,10298,9740,2005,5,NPS,558,frijol
Tabasco,6032,4254,2005,5,D2,1778,frijol
Tamaulipas,919,2,2005,5,NPS,917,frijol
Veracruz de Ignacio de la Llave,23840,20277,2005,5,D1,3563,frijol
Yucatán,901,867,2005,5,D0,34,frijol
Baja California,4,2,2005,6,NPS,2,frijol
Campeche,2926,1539,2005,6,NPS,1387,frijol
Chiapas,45405,32494,2005,6,NPS,12911,frijol
Chihuahua,195,78,2005,6,NPS,117,frijol
Guerrero,88,68,2005,6,D0,20,frijol
Hidalgo,4861,4742,2005,6,NPS,119,frijol
Jalisco,1896,1896,2005,6,D0,0,frijol
Michoacán de Ocampo,40,20,2005,6,D0,20,frijol
Nayarit,40533,32220,2005,6,NPS,8313,frijol
Oaxaca,3375,3305,2005,6,NPS,70,frijol
Puebla,2546,191,2005,6,NPS,2355,frijol
Quintana Roo,2845,2246,2005,6,D0,599,frijol
San Luis Potosí,840,741,2005,6,NPS,99,frijol
Sinaloa,10298,9740,2005,6,NPS,558,frijol
Tabasco,6032,4264,2005,6,D1,1768,frijol
Tamaulipas,919,86,2005,6,NPS,833,frijol
Veracruz de Ignacio de la Llave,23840,22419,2005,6,D0,1421,frijol
Yucatán,901,867,2005,6,NPS,34,frijol
Baja California,4,2,2005,7,NPS,2,frijol
Campeche,2926,1539,2005,7,NPS,1387,frijol
Chiapas,45405,36432,2005,7,NPS,8973,frijol
Chihuahua,195,78,2005,7,NPS,117,frijol
Guerrero,88,88,2005,7,NPS,0,frijol
Hidalgo,4861,4861,2005,7,D0,0,frijol
Jalisco,1896,1896,2005,7,NPS,0,frijol
Michoacán de Ocampo,40,20,2005,7,NPS,20,frijol
Nayarit,40533,32220,2005,7,D0,8313,frijol
Oaxaca,3375,3375,2005,7,NPS,0,frijol
Puebla,2546,355,2005,7,NPS,2191,frijol
Quintana Roo,2845,2246,2005,7,NPS,599,frijol
San Luis Potosí,840,741,2005,7,NPS,99,frijol
Sinaloa,10298,9740,2005,7,NPS,558,frijol
Tabasco,6032,4264,2005,7,D0,1768,frijol
Tamaulipas,919,86,2005,7,NPS,833,frijol
Veracruz de Ignacio de la Llave,23870,22419,2005,7,NPS,1451,frijol
Yucatán,901,867,2005,7,NPS,34,frijol
Baja California,4,2,2005,8,NPS,2,frijol
Campeche,2926,1539,2005,8,NPS,1387,frijol
Chiapas,45405,40650,2005,8,NPS,4755,frijol
Chihuahua,195,78,2005,8,NPS,117,frijol
Guerrero,88,88,2005,8,NPS,0,frijol
Hidalgo,4861,4861,2005,8,NPS,0,frijol
Jalisco,1896,1896,2005,8,NPS,0,frijol
Michoacán de Ocampo,40,20,2005,8,NPS,20,frijol
Nayarit,40533,32220,2005,8,NPS,8313,frijol
Oaxaca,3375,3375,2005,8,NPS,0,frijol
Puebla,2546,355,2005,8,NPS,2191,frijol
Quintana Roo,2845,2246,2005,8,D0,599,frijol
San Luis Potosí,840,741,2005,8,NPS,99,frijol
Sinaloa,10298,9740,2005,8,NPS,558,frijol
Sonora,44,44,2005,8,NPS,0,frijol
Tabasco,6032,4264,2005,8,NPS,1768,frijol
Tamaulipas,919,86,2005,8,NPS,833,frijol
Veracruz de Ignacio de la Llave,23870,22605,2005,8,NPS,1265,frijol
Yucatán,901,867,2005,8,NPS,34,frijol
Baja California,4,2,2005,9,NPS,2,frijol
Campeche,2926,1539,2005,9,NPS,1387,frijol
Chiapas,45405,44335,2005,9,NPS,1070,frijol
Chihuahua,195,78,2005,9,NPS,117,frijol
Guerrero,88,88,2005,9,NPS,0,frijol
Hidalgo,4861,4861,2005,9,NPS,0,frijol
Jalisco,1896,1896,2005,9,D0,0,frijol
Michoacán de Ocampo,40,40,2005,9,D0,0,frijol
Nayarit,40533,32220,2005,9,D0,8313,frijol
Oaxaca,3375,3375,2005,9,NPS,0,frijol
Puebla,2546,355,2005,9,D0,2191,frijol
Quintana Roo,2845,2246,2005,9,NPS,599,frijol
San Luis Potosí,840,741,2005,9,NPS,99,frijol
Sinaloa,10298,9954,2005,9,D0,344,frijol
Sonora,44,44,2005,9,NPS,0,frijol
Tabasco,6032,4264,2005,9,NPS,1768,frijol
Tamaulipas,919,88,2005,9,D0,831,frijol
Veracruz de Ignacio de la Llave,23878,22932,2005,9,NPS,946,frijol
Yucatán,901,867,2005,9,NPS,34,frijol
Baja California,4,2,2005,12,NPS,2,frijol
Campeche,2926,1539,2005,12,D0,1387,frijol
Chiapas,45405,44335,2005,12,NPS,1070,frijol
Chihuahua,195,78,2005,12,D0,117,frijol
Guerrero,88,88,2005,12,D0,0,frijol
Hidalgo,4861,4861,2005,12,D0,0,frijol
Jalisco,1896,1896,2005,12,D1,0,frijol
Michoacán de Ocampo,40,40,2005,12,D1,0,frijol
Nayarit,40533,32220,2005,12,D0,8313,frijol
Oaxaca,3375,3375,2005,12,NPS,0,frijol
Puebla,2546,355,2005,12,D0,2191,frijol
Quintana Roo,2845,2246,2005,12,NPS,599,frijol
San Luis Potosí,840,741,2005,12,D0,99,frijol
Sinaloa,10298,9954,2005,12,D1,344,frijol
Sonora,44,44,2005,12,D0,0,frijol
Tabasco,6032,4264,2005,12,NPS,1768,frijol
Tamaulipas,919,88,2005,12,D0,831,frijol
Veracruz de Ignacio de la Llave,23878,22932,2005,12,NPS,946,frijol
Yucatán,901,867,2005,12,NPS,34,frijol
Chiapas,43807,2190,2006,1,NPS,41617,frijol
Hidalgo,3957,3925,2006,1,D0,32,frijol
Nayarit,46560,60,2006,1,D1,46500,frijol
Oaxaca,2073,338,2006,1,D0,1735,frijol
Sinaloa,11724,2500,2006,1,D1,9224,frijol
Veracruz de Ignacio de la Llave,18326,2651,2006,1,NPS,15675,frijol
Campeche,1347,7,2006,2,NPS,1340,frijol
Chiapas,44998,4838,2006,2,NPS,40160,frijol
Hidalgo,4510,3925,2006,2,D0,585,frijol
Jalisco,2104,1770,2006,2,D1,334,frijol
Nayarit,46602,19981,2006,2,D1,26621,frijol
Oaxaca,2290,488,2006,2,D0,1802,frijol
Quintana Roo,2579,1315,2006,2,NPS,1264,frijol
Sinaloa,11872,5771,2006,2,D3,6101,frijol
Tabasco,4909,100,2006,2,NPS,4809,frijol
Veracruz de Ignacio de la Llave,24500,6157,2006,2,NPS,18343,frijol
Yucatán,273,15,2006,2,NPS,258,frijol
Campeche,1347,7,2006,3,NPS,1340,frijol
Chiapas,45078,25954,2006,3,NPS,19124,frijol
Hidalgo,4675,3925,2006,3,D1,750,frijol
Jalisco,2116,1810,2006,3,D2,306,frijol
Nayarit,46632,46323,2006,3,D2,309,frijol
Oaxaca,2341,665,2006,3,NPS,1676,frijol
Quintana Roo,2579,1450,2006,3,NPS,1129,frijol
San Luis Potosí,682,384,2006,3,D0,298,frijol
Sinaloa,11872,11271,2006,3,D4,601,frijol
Tabasco,4909,1550,2006,3,NPS,3359,frijol
Tamaulipas,747,400,2006,3,D0,347,frijol
Veracruz de Ignacio de la Llave,24726,8952,2006,3,NPS,15774,frijol
Yucatán,273,15,2006,3,NPS,258,frijol
Campeche,2579,2479,2006,4,NPS,100,frijol
Chiapas,45078,36043,2006,4,NPS,9035,frijol
Guerrero,91,83,2006,4,D1,8,frijol
Hidalgo,4675,3925,2006,4,D1,750,frijol
Jalisco,2104,2020,2006,4,D2,84,frijol
Nayarit,46632,46523,2006,4,D2,109,frijol
Oaxaca,2341,936,2006,4,NPS,1405,frijol
Quintana Roo,2579,1450,2006,4,D0,1129,frijol
San Luis Potosí,682,635,2006,4,D0,47,frijol
Sinaloa,11872,11271,2006,4,D4,601,frijol
Tabasco,5013,4448,2006,4,NPS,565,frijol
Tamaulipas,747,712,2006,4,D0,35,frijol
Veracruz de Ignacio de la Llave,24792,12029,2006,4,NPS,12763,frijol
Yucatán,273,16,2006,4,D0,257,frijol
Campeche,2579,2559,2006,5,NPS,20,frijol
Chiapas,45078,42362,2006,5,NPS,2716,frijol
Guerrero,91,91,2006,5,NPS,0,frijol
Hidalgo,4675,4285,2006,5,D0,390,frijol
Jalisco,2104,2099,2006,5,D2,5,frijol
Nayarit,46632,46523,2006,5,D2,109,frijol
Oaxaca,2341,1464,2006,5,NPS,877,frijol
Puebla,333,15,2006,5,D0,318,frijol
Quintana Roo,2579,1450,2006,5,NPS,1129,frijol
San Luis Potosí,682,682,2006,5,NPS,0,frijol
Sinaloa,11872,11271,2006,5,D4,601,frijol
Tabasco,5013,4820,2006,5,NPS,193,frijol
Tamaulipas,747,712,2006,5,NPS,35,frijol
Veracruz de Ignacio de la Llave,24792,17796,2006,5,NPS,6996,frijol
Yucatán,273,16,2006,5,NPS,257,frijol
Campeche,2579,2559,2006,6,NPS,20,frijol
Chiapas,45078,43345,2006,6,NPS,1733,frijol
Guerrero,91,91,2006,6,NPS,0,frijol
Hidalgo,4675,4585,2006,6,D0,90,frijol
Jalisco,2104,2099,2006,6,D2,5,frijol
Nayarit,46632,46523,2006,6,D3,109,frijol
Oaxaca,2906,2884,2006,6,NPS,22,frijol
Puebla,333,284,2006,6,D0,49,frijol
Quintana Roo,2579,1490,2006,6,D0,1089,frijol
San Luis Potosí,682,682,2006,6,D0,0,frijol
Sinaloa,11872,11281,2006,6,D4,591,frijol
Tabasco,5013,4820,2006,6,NPS,193,frijol
Tamaulipas,747,712,2006,6,D0,35,frijol
Veracruz de Ignacio de la Llave,24792,21746,2006,6,NPS,3046,frijol
Yucatán,273,16,2006,6,NPS,257,frijol
Campeche,2579,2559,2006,7,NPS,20,frijol
Chiapas,45078,44767,2006,7,NPS,311,frijol
Guerrero,91,91,2006,7,NPS,0,frijol
Hidalgo,4675,4675,2006,7,D0,0,frijol
Jalisco,2104,2104,2006,7,D1,0,frijol
Michoacán de Ocampo,146,146,2006,7,D0,0,frijol
Nayarit,46632,46523,2006,7,D2,109,frijol
Oaxaca,2906,2904,2006,7,NPS,2,frijol
Puebla,333,333,2006,7,D0,0,frijol
Quintana Roo,2579,1490,2006,7,NPS,1089,frijol
San Luis Potosí,682,682,2006,7,D0,0,frijol
Sinaloa,11872,11333,2006,7,D3,539,frijol
Tabasco,5013,4820,2006,7,NPS,193,frijol
Tamaulipas,747,712,2006,7,D0,35,frijol
Veracruz de Ignacio de la Llave,24792,21746,2006,7,NPS,3046,frijol
Yucatán,273,16,2006,7,D0,257,frijol
Campeche,2579,2559,2006,8,NPS,20,frijol
Chiapas,45078,44767,2006,8,NPS,311,frijol
Guerrero,91,91,2006,8,NPS,0,frijol
Hidalgo,4675,4675,2006,8,NPS,0,frijol
Jalisco,2104,2104,2006,8,D0,0,frijol
Michoacán de Ocampo,146,146,2006,8,D0,0,frijol
Nayarit,46632,46523,2006,8,D1,109,frijol
Oaxaca,2906,2904,2006,8,NPS,2,frijol
Puebla,333,333,2006,8,D0,0,frijol
Quintana Roo,2579,1490,2006,8,NPS,1089,frijol
San Luis Potosí,682,682,2006,8,NPS,0,frijol
Sinaloa,11872,11333,2006,8,D1,539,frijol
Tabasco,5013,4820,2006,8,NPS,193,frijol
Tamaulipas,747,747,2006,8,D0,0,frijol
Veracruz de Ignacio de la Llave,24792,21935,2006,8,D1,2857,frijol
Yucatán,273,16,2006,8,NPS,257,frijol
Campeche,2579,2559,2006,9,D0,20,frijol
Chiapas,45078,44767,2006,9,D0,311,frijol
Guerrero,91,91,2006,9,NPS,0,frijol
Hidalgo,4675,4675,2006,9,NPS,0,frijol
Jalisco,2104,2104,2006,9,D0,0,frijol
Michoacán de Ocampo,146,146,2006,9,NPS,0,frijol
Nayarit,46632,46523,2006,9,D1,109,frijol
Oaxaca,2906,2904,2006,9,NPS,2,frijol
Puebla,333,333,2006,9,NPS,0,frijol
Quintana Roo,2579,1490,2006,9,NPS,1089,frijol
San Luis Potosí,682,682,2006,9,NPS,0,frijol
Sinaloa,11872,11333,2006,9,NPS,539,frijol
Tabasco,5013,4820,2006,9,D0,193,frijol
Tamaulipas,747,747,2006,9,D0,0,frijol
Veracruz de Ignacio de la Llave,24792,21935,2006,9,NPS,2857,frijol
Yucatán,273,16,2006,9,D0,257,frijol
Campeche,2579,2559,2006,12,NPS,20,frijol
Chiapas,45078,44767,2006,12,NPS,311,frijol
Guerrero,91,91,2006,12,NPS,0,frijol
Hidalgo,4675,4675,2006,12,NPS,0,frijol
Jalisco,2104,2104,2006,12,NPS,0,frijol
Michoacán de Ocampo,146,146,2006,12,NPS,0,frijol
Nayarit,46632,46523,2006,12,D0,109,frijol
Oaxaca,2906,2904,2006,12,NPS,2,frijol
Puebla,333,333,2006,12,NPS,0,frijol
Quintana Roo,2579,1490,2006,12,NPS,1089,frijol
San Luis Potosí,682,682,2006,12,NPS,0,frijol
Sinaloa,11872,11333,2006,12,NPS,539,frijol
Tabasco,5013,4820,2006,12,NPS,193,frijol
Tamaulipas,747,747,2006,12,NPS,0,frijol
Veracruz de Ignacio de la Llave,24792,21935,2006,12,NPS,2857,frijol
Yucatán,273,16,2006,12,NPS,257,frijol
Campeche,1748,360,2007,1,NPS,1388,frijol
Chiapas,44200,5744,2007,1,NPS,38456,frijol
Hidalgo,4038,3572,2007,1,D1,466,frijol
Jalisco,1974,6,2007,1,NPS,1968,frijol
Nayarit,41155,155,2007,1,D1,41000,frijol
Oaxaca,3921,224,2007,1,NPS,3697,frijol
Quintana Roo,2818,675,2007,1,D0,2143,frijol
Veracruz de Ignacio de la Llave,17927,1056,2007,1,NPS,16871,frijol
Yucatán,340,132,2007,1,NPS,208,frijol
Campeche,1752,360,2007,2,NPS,1392,frijol
Chiapas,45124,9772,2007,2,NPS,35352,frijol
Hidalgo,4668,3918,2007,2,NPS,750,frijol
Jalisco,1964,1269,2007,2,NPS,695,frijol
Nayarit,42529,25787,2007,2,D1,16742,frijol
Oaxaca,4118,860,2007,2,NPS,3258,frijol
Quintana Roo,2870,2537,2007,2,D1,333,frijol
Sinaloa,12196,4740,2007,2,D0,7456,frijol
Tabasco,4574,180,2007,2,NPS,4394,frijol
Tamaulipas,671,220,2007,2,NPS,451,frijol
Veracruz de Ignacio de la Llave,20510,4917,2007,2,NPS,15593,frijol
Yucatán,340,192,2007,2,NPS,148,frijol
Campeche,1762,945,2007,3,NPS,817,frijol
Chiapas,45124,35234,2007,3,D0,9890,frijol
Guerrero,103,55,2007,3,D1,48,frijol
Hidalgo,4668,3918,2007,3,NPS,750,frijol
Jalisco,1964,1841,2007,3,D0,123,frijol
Nayarit,42576,41781,2007,3,D1,795,frijol
Oaxaca,3309,1816,2007,3,NPS,1493,frijol
Quintana Roo,2870,2704,2007,3,NPS,166,frijol
Sinaloa,12280,9212,2007,3,D1,3068,frijol
Tabasco,4620,1804,2007,3,NPS,2816,frijol
Tamaulipas,701,420,2007,3,NPS,281,frijol
Veracruz de Ignacio de la Llave,21128,10658,2007,3,NPS,10470,frijol
Yucatán,340,266,2007,3,NPS,74,frijol
Campeche,1762,1025,2007,4,D0,737,frijol
Chiapas,45124,40206,2007,4,D2,4918,frijol
Guerrero,103,95,2007,4,NPS,8,frijol
Hidalgo,4668,3918,2007,4,NPS,750,frijol
Jalisco,1964,1964,2007,4,D2,0,frijol
Nayarit,42576,41801,2007,4,D2,775,frijol
Oaxaca,3309,1171,2007,4,D0,2138,frijol
Quintana Roo,2870,2707,2007,4,D2,163,frijol
San Luis Potosí,1768,303,2007,4,NPS,1465,frijol
Sinaloa,12298,9230,2007,4,D3,3068,frijol
Tabasco,4620,2707,2007,4,D0,1913,frijol
Tamaulipas,714,457,2007,4,NPS,257,frijol
Veracruz de Ignacio de la Llave,21110,13972,2007,4,NPS,7138,frijol
Yucatán,334,272,2007,4,D1,62,frijol
Campeche,2802,2075,2007,5,D0,727,frijol
Chiapas,45124,43114,2007,5,D1,2010,frijol
Chihuahua,8,3,2007,5,NPS,5,frijol
Guerrero,103,103,2007,5,NPS,0,frijol
Hidalgo,4668,4583,2007,5,NPS,85,frijol
Jalisco,1964,1964,2007,5,D1,0,frijol
Nayarit,42576,41801,2007,5,D1,775,frijol
Oaxaca,3319,3319,2007,5,NPS,0,frijol
Puebla,356,16,2007,5,NPS,340,frijol
Quintana Roo,2870,2707,2007,5,D2,163,frijol
San Luis Potosí,1768,1768,2007,5,NPS,0,frijol
Sinaloa,12298,9230,2007,5,D1,3068,frijol
Tabasco,4620,3627,2007,5,D1,993,frijol
Tamaulipas,714,567,2007,5,NPS,147,frijol
Veracruz de Ignacio de la Llave,21110,20128,2007,5,NPS,982,frijol
Yucatán,334,272,2007,5,D2,62,frijol
Campeche,2802,2737,2007,6,D1,65,frijol
Chiapas,45124,44680,2007,6,D1,444,frijol
Chihuahua,8,5,2007,6,NPS,3,frijol
Guerrero,103,103,2007,6,D0,0,frijol
Hidalgo,4668,4668,2007,6,NPS,0,frijol
Jalisco,1964,1964,2007,6,D3,0,frijol
Michoacán de Ocampo,210,150,2007,6,D1,60,frijol
Nayarit,42576,41801,2007,6,D1,775,frijol
Oaxaca,3319,3319,2007,6,D0,0,frijol
Puebla,356,346,2007,6,D0,10,frijol
Quintana Roo,2870,2707,2007,6,D2,163,frijol
San Luis Potosí,1768,1768,2007,6,NPS,0,frijol
Sinaloa,12298,9230,2007,6,D1,3068,frijol
Tabasco,4624,3988,2007,6,D2,636,frijol
Tamaulipas,714,597,2007,6,NPS,117,frijol
Veracruz de Ignacio de la Llave,21110,20288,2007,6,D0,822,frijol
Yucatán,334,272,2007,6,D1,62,frijol
Campeche,2802,2737,2007,7,D2,65,frijol
Chiapas,45124,44969,2007,7,NPS,155,frijol
Chihuahua,8,5,2007,7,D0,3,frijol
Guerrero,103,103,2007,7,NPS,0,frijol
Hidalgo,4668,4668,2007,7,NPS,0,frijol
Jalisco,1964,1964,2007,7,D1,0,frijol
Michoacán de Ocampo,210,150,2007,7,D3,60,frijol
Nayarit,42576,41801,2007,7,D1,775,frijol
Oaxaca,3319,3319,2007,7,NPS,0,frijol
Puebla,356,356,2007,7,D1,0,frijol
Quintana Roo,2870,2707,2007,7,D0,163,frijol
San Luis Potosí,1768,1768,2007,7,NPS,0,frijol
Sinaloa,12298,11730,2007,7,D2,568,frijol
Tabasco,4624,3988,2007,7,D3,636,frijol
Tamaulipas,714,627,2007,7,NPS,87,frijol
Veracruz de Ignacio de la Llave,21128,20444,2007,7,D1,684,frijol
Yucatán,334,272,2007,7,D0,62,frijol
Campeche,2802,2737,2007,8,NPS,65,frijol
Chiapas,45124,44969,2007,8,NPS,155,frijol
Chihuahua,8,5,2007,8,NPS,3,frijol
Guerrero,103,103,2007,8,NPS,0,frijol
Hidalgo,4668,4668,2007,8,NPS,0,frijol
Jalisco,1964,1964,2007,8,NPS,0,frijol
Michoacán de Ocampo,210,152,2007,8,NPS,58,frijol
Nayarit,42576,41801,2007,8,NPS,775,frijol
Oaxaca,3319,3319,2007,8,NPS,0,frijol
Puebla,356,356,2007,8,NPS,0,frijol
Quintana Roo,2870,2707,2007,8,NPS,163,frijol
San Luis Potosí,1768,1768,2007,8,NPS,0,frijol
Sinaloa,12298,11730,2007,8,NPS,568,frijol
Tabasco,4624,4003,2007,8,D1,621,frijol
Tamaulipas,714,714,2007,8,NPS,0,frijol
Veracruz de Ignacio de la Llave,21128,20842,2007,8,NPS,286,frijol
Yucatán,334,272,2007,8,NPS,62,frijol
Campeche,2802,2737,2007,9,D1,65,frijol
Chiapas,45124,44969,2007,9,D0,155,frijol
Chihuahua,8,5,2007,9,D0,3,frijol
Guerrero,103,103,2007,9,NPS,0,frijol
Hidalgo,4668,4668,2007,9,NPS,0,frijol
Jalisco,1964,1964,2007,9,D0,0,frijol
Michoacán de Ocampo,210,210,2007,9,D0,0,frijol
Nayarit,42576,41801,2007,9,D0,775,frijol
Oaxaca,3319,3319,2007,9,NPS,0,frijol
Puebla,356,356,2007,9,NPS,0,frijol
Quintana Roo,2870,2707,2007,9,D1,163,frijol
San Luis Potosí,1768,1768,2007,9,NPS,0,frijol
Sinaloa,12298,11730,2007,9,NPS,568,frijol
Sonora,50,50,2007,9,NPS,0,frijol
Tabasco,4624,4003,2007,9,D1,621,frijol
Tamaulipas,714,714,2007,9,NPS,0,frijol
Veracruz de Ignacio de la Llave,21128,20842,2007,9,NPS,286,frijol
Yucatán,334,272,2007,9,D0,62,frijol
Sinaloa,3160,1200,2007,11,D0,1960,frijol
Campeche,2802,2737,2007,12,NPS,65,frijol
Chiapas,45124,44969,2007,12,NPS,155,frijol
Chihuahua,8,5,2007,12,D0,3,frijol
Guerrero,103,103,2007,12,NPS,0,frijol
Hidalgo,4668,4668,2007,12,NPS,0,frijol
Jalisco,1964,1964,2007,12,D2,0,frijol
Michoacán de Ocampo,210,210,2007,12,NPS,0,frijol
Nayarit,42576,41801,2007,12,D1,775,frijol
Oaxaca,3319,3319,2007,12,NPS,0,frijol
Puebla,356,356,2007,12,NPS,0,frijol
Quintana Roo,2870,2707,2007,12,D2,163,frijol
San Luis Potosí,1768,1768,2007,12,NPS,0,frijol
Sinaloa,12298,11730,2007,12,D1,568,frijol
Sonora,50,50,2007,12,NPS,0,frijol
Tabasco,4624,4003,2007,12,NPS,621,frijol
Tamaulipas,714,714,2007,12,D0,0,frijol
Veracruz de Ignacio de la Llave,21128,20842,2007,12,NPS,286,frijol
Yucatán,334,272,2007,12,NPS,62,frijol
Chiapas,42100,2876,2008,1,NPS,39224,frijol
Hidalgo,4172,3992,2008,1,NPS,180,frijol
Nayarit,34898,757,2008,1,D2,34141,frijol
Quintana Roo,3078,361,2008,1,D2,2717,frijol
San Luis Potosí,1440,58,2008,1,NPS,1382,frijol
Sinaloa,7642,3000,2008,1,D1,4642,frijol
Veracruz de Ignacio de la Llave,21880,915,2008,1,NPS,20965,frijol
Yucatán,601,220,2008,1,D2,381,frijol
Chiapas,42764,6905,2008,2,NPS,35859,frijol
Hidalgo,4680,3992,2008,2,NPS,688,frijol
Nayarit,34898,8128,2008,2,D2,26770,frijol
Oaxaca,2444,815,2008,2,NPS,1629,frijol
Quintana Roo,3091,1088,2008,2,D2,2003,frijol
San Luis Potosí,1444,58,2008,2,NPS,1386,frijol
Sinaloa,7726,4022,2008,2,D1,3704,frijol
Tabasco,4237,1059,2008,2,D0,3178,frijol
Tamaulipas,499,4,2008,2,NPS,495,frijol
Veracruz de Ignacio de la Llave,27873,2953,2008,2,NPS,24920,frijol
Campeche,2355,1275,2008,3,NPS,1080,frijol
Chiapas,43414,22210,2008,3,NPS,21204,frijol
Guerrero,95,56,2008,3,D1,39,frijol
Hidalgo,4680,3992,2008,3,NPS,688,frijol
Jalisco,2059,145,2008,3,D1,1914,frijol
Nayarit,34898,34898,2008,3,D2,0,frijol
Oaxaca,2444,1387,2008,3,D0,1057,frijol
Quintana Roo,3099,2212,2008,3,D0,887,frijol
San Luis Potosí,1490,834,2008,3,NPS,656,frijol
Sinaloa,7750,6269,2008,3,D1,1481,frijol
Tabasco,4503,2425,2008,3,D1,2078,frijol
Tamaulipas,527,164,2008,3,NPS,363,frijol
Veracruz de Ignacio de la Llave,28673,13698,2008,3,NPS,14975,frijol
Yucatán,601,524,2008,3,NPS,77,frijol
Campeche,2355,1470,2008,4,D0,885,frijol
Chiapas,43414,33713,2008,4,NPS,9701,frijol
Guerrero,95,95,2008,4,D1,0,frijol
Hidalgo,4680,3992,2008,4,NPS,688,frijol
Jalisco,2059,1886,2008,4,D1,173,frijol
Nayarit,34898,34898,2008,4,D3,0,frijol
Oaxaca,2444,1793,2008,4,NPS,651,frijol
Quintana Roo,3109,2554,2008,4,D1,555,frijol
San Luis Potosí,1490,1264,2008,4,NPS,226,frijol
Sinaloa,7750,6279,2008,4,D1,1471,frijol
Tabasco,4748,3245,2008,4,D2,1503,frijol
Tamaulipas,527,482,2008,4,D0,45,frijol
Veracruz de Ignacio de la Llave,28673,16542,2008,4,D0,12131,frijol
Yucatán,601,547,2008,4,NPS,54,frijol
Campeche,2355,2280,2008,5,D0,75,frijol
Chiapas,43414,36698,2008,5,NPS,6716,frijol
Chihuahua,21,8,2008,5,D0,13,frijol
Guerrero,95,95,2008,5,D1,0,frijol
Hidalgo,4680,4517,2008,5,D0,163,frijol
Jalisco,2059,2040,2008,5,D1,19,frijol
Michoacán de Ocampo,58,50,2008,5,D3,8,frijol
Nayarit,34898,34898,2008,5,D3,0,frijol
Oaxaca,2444,2420,2008,5,D0,24,frijol
Quintana Roo,3109,2560,2008,5,D2,549,frijol
San Luis Potosí,1490,1490,2008,5,NPS,0,frijol
Sinaloa,7750,6297,2008,5,D1,1453,frijol
Tabasco,4807,3856,2008,5,D2,951,frijol
Tamaulipas,527,482,2008,5,D1,45,frijol
Veracruz de Ignacio de la Llave,28673,24540,2008,5,D2,4133,frijol
Yucatán,601,547,2008,5,NPS,54,frijol
Campeche,3030,2955,2008,6,D0,75,frijol
Chiapas,43414,37869,2008,6,NPS,5545,frijol
Chihuahua,21,8,2008,6,D1,13,frijol
Guerrero,95,95,2008,6,D0,0,frijol
Hidalgo,4680,4680,2008,6,D0,0,frijol
Jalisco,2059,2040,2008,6,D1,19,frijol
Michoacán de Ocampo,58,50,2008,6,D3,8,frijol
Nayarit,34898,34898,2008,6,D3,0,frijol
Oaxaca,2444,2444,2008,6,NPS,0,frijol
Puebla,323,259,2008,6,D0,64,frijol
Quintana Roo,3109,2570,2008,6,D1,539,frijol
San Luis Potosí,1490,1490,2008,6,NPS,0,frijol
Sinaloa,7750,6297,2008,6,D0,1453,frijol
Tabasco,4807,4058,2008,6,D0,749,frijol
Tamaulipas,527,482,2008,6,NPS,45,frijol
Veracruz de Ignacio de la Llave,28673,26546,2008,6,D0,2127,frijol
Yucatán,601,547,2008,6,NPS,54,frijol
Campeche,3030,2955,2008,7,D0,75,frijol
Chiapas,43414,41196,2008,7,NPS,2218,frijol
Chihuahua,21,8,2008,7,NPS,13,frijol
Guerrero,95,95,2008,7,NPS,0,frijol
Hidalgo,4680,4680,2008,7,NPS,0,frijol
Jalisco,2059,2055,2008,7,D1,4,frijol
Michoacán de Ocampo,58,58,2008,7,D1,0,frijol
Nayarit,34898,34898,2008,7,D2,0,frijol
Oaxaca,2444,2444,2008,7,NPS,0,frijol
Puebla,323,323,2008,7,NPS,0,frijol
Quintana Roo,3109,3109,2008,7,NPS,0,frijol
San Luis Potosí,1490,1490,2008,7,NPS,0,frijol
Sinaloa,7750,7617,2008,7,NPS,133,frijol
Tabasco,4807,4559,2008,7,NPS,248,frijol
Tamaulipas,527,487,2008,7,NPS,40,frijol
Veracruz de Ignacio de la Llave,28673,27707,2008,7,D0,966,frijol
Yucatán,601,547,2008,7,NPS,54,frijol
Campeche,3030,2955,2008,8,D1,75,frijol
Chiapas,43414,41749,2008,8,NPS,1665,frijol
Chihuahua,21,8,2008,8,NPS,13,frijol
Guerrero,95,95,2008,8,NPS,0,frijol
Hidalgo,4680,4680,2008,8,NPS,0,frijol
Jalisco,2059,2055,2008,8,D1,4,frijol
Michoacán de Ocampo,58,58,2008,8,D2,0,frijol
Nayarit,34898,34898,2008,8,D1,0,frijol
Oaxaca,2444,2444,2008,8,NPS,0,frijol
Puebla,323,323,2008,8,NPS,0,frijol
Quintana Roo,3109,3109,2008,8,NPS,0,frijol
San Luis Potosí,1490,1490,2008,8,NPS,0,frijol
Sinaloa,7750,7617,2008,8,NPS,133,frijol
Tabasco,4807,4559,2008,8,NPS,248,frijol
Tamaulipas,527,507,2008,8,NPS,20,frijol
Veracruz de Ignacio de la Llave,28673,27872,2008,8,D0,801,frijol
Yucatán,601,547,2008,8,NPS,54,frijol
Campeche,3030,2955,2008,9,D1,75,frijol
Chiapas,43414,41749,2008,9,NPS,1665,frijol
Chihuahua,21,8,2008,9,NPS,13,frijol
Guerrero,95,95,2008,9,NPS,0,frijol
Hidalgo,4680,4680,2008,9,NPS,0,frijol
Jalisco,2059,2055,2008,9,NPS,4,frijol
Michoacán de Ocampo,58,58,2008,9,D1,0,frijol
Nayarit,34898,34898,2008,9,NPS,0,frijol
Oaxaca,2444,2444,2008,9,NPS,0,frijol
Puebla,323,323,2008,9,NPS,0,frijol
Quintana Roo,3109,3109,2008,9,NPS,0,frijol
San Luis Potosí,1490,1490,2008,9,NPS,0,frijol
Sinaloa,7750,7617,2008,9,NPS,133,frijol
Tabasco,4807,4559,2008,9,NPS,248,frijol
Tamaulipas,527,507,2008,9,NPS,20,frijol
Veracruz de Ignacio de la Llave,28673,27932,2008,9,D0,741,frijol
Yucatán,601,547,2008,9,NPS,54,frijol
Campeche,3030,2955,2008,12,D0,75,frijol
Chiapas,43414,41749,2008,12,D0,1665,frijol
Chihuahua,21,8,2008,12,NPS,13,frijol
Guerrero,95,95,2008,12,NPS,0,frijol
Hidalgo,4680,4680,2008,12,NPS,0,frijol
Jalisco,2059,2055,2008,12,D0,4,frijol
Michoacán de Ocampo,58,58,2008,12,D1,0,frijol
Nayarit,34898,34898,2008,12,D0,0,frijol
Oaxaca,2444,2444,2008,12,NPS,0,frijol
Puebla,323,323,2008,12,NPS,0,frijol
Quintana Roo,3109,3109,2008,12,D0,0,frijol
San Luis Potosí,1490,1490,2008,12,NPS,0,frijol
Sinaloa,7750,7617,2008,12,NPS,133,frijol
Tabasco,4807,4559,2008,12,D1,248,frijol
Tamaulipas,527,507,2008,12,NPS,20,frijol
Veracruz de Ignacio de la Llave,28673,27932,2008,12,D0,741,frijol
Yucatán,601,547,2008,12,D0,54,frijol
Chiapas,42797,1482,2009,1,D0,41315,frijol
Hidalgo,4392,4171,2009,1,NPS,221,frijol
Nayarit,33441,2362,2009,1,D0,31079,frijol
Quintana Roo,3166,875,2009,1,NPS,2291,frijol
Sinaloa,4096,16,2009,1,D0,4080,frijol
Veracruz de Ignacio de la Llave,16838,3826,2009,1,D0,13012,frijol
Yucatán,320,250,2009,1,D1,70,frijol
Chiapas,43353,3499,2009,2,D0,39854,frijol
Hidalgo,4839,4171,2009,2,NPS,668,frijol
Jalisco,1818,350,2009,2,NPS,1468,frijol
Nayarit,33443,26363,2009,2,D0,7080,frijol
Oaxaca,2417,470,2009,2,NPS,1947,frijol
Quintana Roo,3232,1250,2009,2,D0,1982,frijol
San Luis Potosí,1704,305,2009,2,NPS,1399,frijol
Sinaloa,4097,1698,2009,2,D0,2399,frijol
Tabasco,3984,950,2009,2,D1,3034,frijol
Tamaulipas,476,200,2009,2,NPS,276,frijol
Veracruz de Ignacio de la Llave,32731,6452,2009,2,D0,26279,frijol
Yucatán,320,318,2009,2,D1,2,frijol
Campeche,2682,1239,2009,3,D1,1443,frijol
Chiapas,44523,17281,2009,3,D0,27242,frijol
Guerrero,95,53,2009,3,NPS,42,frijol
Hidalgo,4839,4171,2009,3,NPS,668,frijol
Jalisco,1818,550,2009,3,D1,1268,frijol
Nayarit,33443,27613,2009,3,D0,5830,frijol
Oaxaca,2432,1197,2009,3,NPS,1235,frijol
Quintana Roo,3240,2004,2009,3,D0,1236,frijol
San Luis Potosí,1749,305,2009,3,NPS,1444,frijol
Sinaloa,5314,4576,2009,3,D1,738,frijol
Tabasco,3992,2094,2009,3,D1,1898,frijol
Tamaulipas,585,450,2009,3,NPS,135,frijol
Veracruz de Ignacio de la Llave,29731,7137,2009,3,NPS,22594,frijol
Yucatán,320,318,2009,3,D1,2,frijol
Campeche,2722,2007,2009,4,D1,715,frijol
Chiapas,44523,31882,2009,4,D0,12641,frijol
Guerrero,95,95,2009,4,NPS,0,frijol
Hidalgo,4839,4171,2009,4,NPS,668,frijol
Jalisco,2031,1120,2009,4,D1,911,frijol
Michoacán de Ocampo,70,65,2009,4,D1,5,frijol
Nayarit,33443,33443,2009,4,D0,0,frijol
Oaxaca,2465,1807,2009,4,NPS,658,frijol
Quintana Roo,3240,2290,2009,4,D0,950,frijol
San Luis Potosí,1749,1749,2009,4,NPS,0,frijol
Sinaloa,5845,5119,2009,4,NPS,726,frijol
Tabasco,3992,3420,2009,4,D1,572,frijol
Tamaulipas,585,541,2009,4,NPS,44,frijol
Veracruz de Ignacio de la Llave,29731,16560,2009,4,D0,13171,frijol
Yucatán,320,318,2009,4,D2,2,frijol
Campeche,2722,2167,2009,5,D1,555,frijol
Chiapas,44583,37352,2009,5,NPS,7231,frijol
Guerrero,95,95,2009,5,NPS,0,frijol
Hidalgo,4839,4624,2009,5,NPS,215,frijol
Jalisco,2031,1778,2009,5,D1,253,frijol
Michoacán de Ocampo,70,65,2009,5,D1,5,frijol
Nayarit,33443,33443,2009,5,D0,0,frijol
Oaxaca,2465,2258,2009,5,NPS,207,frijol
Querétaro de Arteaga,15,15,2009,5,NPS,0,frijol
Quintana Roo,3240,2982,2009,5,D1,258,frijol
San Luis Potosí,1749,1749,2009,5,NPS,0,frijol
Sinaloa,6095,5119,2009,5,D0,976,frijol
Tabasco,4138,3928,2009,5,D1,210,frijol
Tamaulipas,585,551,2009,5,NPS,34,frijol
Veracruz de Ignacio de la Llave,29881,19352,2009,5,D0,10529,frijol
Yucatán,320,318,2009,5,D2,2,frijol
Campeche,2722,2177,2009,6,D1,545,frijol
Chiapas,44583,38452,2009,6,NPS,6131,frijol
Guerrero,95,95,2009,6,NPS,0,frijol
Hidalgo,4839,4839,2009,6,D0,0,frijol
Jalisco,2031,2021,2009,6,D1,10,frijol
Michoacán de Ocampo,70,67,2009,6,D1,3,frijol
Nayarit,33443,33443,2009,6,D0,0,frijol
Oaxaca,2465,2465,2009,6,NPS,0,frijol
Puebla,361,169,2009,6,D0,192,frijol
Querétaro de Arteaga,15,15,2009,6,D0,0,frijol
Quintana Roo,3240,3234,2009,6,D1,6,frijol
San Luis Potosí,1749,1749,2009,6,NPS,0,frijol
Sinaloa,6095,5119,2009,6,NPS,976,frijol
Tabasco,4138,3928,2009,6,D1,210,frijol
Tamaulipas,585,551,2009,6,NPS,34,frijol
Veracruz de Ignacio de la Llave,29881,21262,2009,6,D0,8619,frijol
Yucatán,318,318,2009,6,D2,0,frijol
Campeche,2722,2177,2009,7,D2,545,frijol
Chiapas,44583,41672,2009,7,D0,2911,frijol
Guerrero,95,95,2009,7,NPS,0,frijol
Hidalgo,4839,4839,2009,7,D0,0,frijol
Jalisco,2031,2021,2009,7,D1,10,frijol
Michoacán de Ocampo,70,67,2009,7,D2,3,frijol
Nayarit,33443,33443,2009,7,D0,0,frijol
Oaxaca,2465,2465,2009,7,NPS,0,frijol
Puebla,361,361,2009,7,D0,0,frijol
Querétaro de Arteaga,15,15,2009,7,D0,0,frijol
Quintana Roo,3240,3234,2009,7,D1,6,frijol
San Luis Potosí,1749,1749,2009,7,NPS,0,frijol
Sinaloa,6095,5369,2009,7,NPS,726,frijol
Tabasco,4138,3928,2009,7,D1,210,frijol
Tamaulipas,585,552,2009,7,D0,33,frijol
Veracruz de Ignacio de la Llave,29881,21502,2009,7,D0,8379,frijol
Yucatán,318,318,2009,7,D2,0,frijol
Campeche,2722,2177,2009,8,D2,545,frijol
Chiapas,44583,42635,2009,8,D1,1948,frijol
Guerrero,95,95,2009,8,D0,0,frijol
Hidalgo,4839,4839,2009,8,D1,0,frijol
Jalisco,2031,2021,2009,8,D2,10,frijol
Michoacán de Ocampo,70,67,2009,8,D2,3,frijol
Nayarit,33443,33443,2009,8,D1,0,frijol
Oaxaca,2465,2465,2009,8,D0,0,frijol
Puebla,361,361,2009,8,D1,0,frijol
Querétaro de Arteaga,15,15,2009,8,D1,0,frijol
Quintana Roo,3240,3234,2009,8,D0,6,frijol
San Luis Potosí,1749,1749,2009,8,NPS,0,frijol
Sinaloa,6095,5369,2009,8,NPS,726,frijol
Tabasco,4138,3928,2009,8,D2,210,frijol
Tamaulipas,585,552,2009,8,D3,33,frijol
Veracruz de Ignacio de la Llave,29881,21502,2009,8,D1,8379,frijol
Yucatán,318,318,2009,8,D2,0,frijol
Campeche,2722,2677,2009,9,D3,45,frijol
Chiapas,44583,44503,2009,9,D2,80,frijol
Guerrero,95,95,2009,9,NPS,0,frijol
Hidalgo,4839,4839,2009,9,NPS,0,frijol
Jalisco,2031,2021,2009,9,D1,10,frijol
Michoacán de Ocampo,70,70,2009,9,D2,0,frijol
Nayarit,33443,33443,2009,9,D1,0,frijol
Oaxaca,2465,2465,2009,9,NPS,0,frijol
Puebla,361,361,2009,9,NPS,0,frijol
Querétaro de Arteaga,15,15,2009,9,NPS,0,frijol
Quintana Roo,3240,3234,2009,9,D2,6,frijol
San Luis Potosí,1749,1749,2009,9,NPS,0,frijol
Sinaloa,6095,5369,2009,9,NPS,726,frijol
Tabasco,4138,3928,2009,9,D3,210,frijol
Tamaulipas,585,552,2009,9,D1,33,frijol
Veracruz de Ignacio de la Llave,29881,29801,2009,9,NPS,80,frijol
Yucatán,318,318,2009,9,D3,0,frijol
Campeche,2722,2677,2009,12,D2,45,frijol
Chiapas,44583,44503,2009,12,D2,80,frijol
Guerrero,95,95,2009,12,NPS,0,frijol
Hidalgo,4839,4839,2009,12,NPS,0,frijol
Jalisco,2031,2021,2009,12,D1,10,frijol
Michoacán de Ocampo,70,70,2009,12,D2,0,frijol
Nayarit,33443,33443,2009,12,NPS,0,frijol
Oaxaca,2465,2465,2009,12,NPS,0,frijol
Puebla,361,361,2009,12,D0,0,frijol
Querétaro de Arteaga,15,15,2009,12,NPS,0,frijol
Quintana Roo,3240,3234,2009,12,D0,6,frijol
San Luis Potosí,1749,1749,2009,12,NPS,0,frijol
Sinaloa,6095,5369,2009,12,D0,726,frijol
Tabasco,4138,3928,2009,12,D3,210,frijol
Tamaulipas,585,552,2009,12,D0,33,frijol
Veracruz de Ignacio de la Llave,29881,29801,2009,12,NPS,80,frijol
Yucatán,318,318,2009,12,D3,0,frijol
Chiapas,43279,1760,2010,1,D2,41519,frijol
Hidalgo,4211,3011,2010,1,NPS,1200,frijol
Nayarit,40381,2203,2010,1,NPS,38178,frijol
Oaxaca,2530,20,2010,1,NPS,2510,frijol
Quintana Roo,2853,5,2010,1,D0,2848,frijol
San Luis Potosí,5864,2870,2010,1,NPS,2994,frijol
Tamaulipas,606,36,2010,1,NPS,570,frijol
Veracruz de Ignacio de la Llave,22342,2069,2010,1,NPS,20273,frijol
Yucatán,288,84,2010,1,D3,204,frijol
Campeche,2560,1492,2010,2,D2,1068,frijol
Chiapas,44479,7510,2010,2,D3,36969,frijol
Hidalgo,4694,3749,2010,2,NPS,945,frijol
Nayarit,40381,28564,2010,2,NPS,11817,frijol
Oaxaca,2667,999,2010,2,NPS,1668,frijol
Puebla,377,43,2010,2,NPS,334,frijol
Quintana Roo,2859,1770,2010,2,D1,1089,frijol
San Luis Potosí,6398,2870,2010,2,NPS,3528,frijol
Sinaloa,3308,1780,2010,2,NPS,1528,frijol
Sonora,95,85,2010,2,NPS,10,frijol
Tabasco,4616,1406,2010,2,D3,3210,frijol
Tamaulipas,656,36,2010,2,NPS,620,frijol
Veracruz de Ignacio de la Llave,23275,6443,2010,2,NPS,16832,frijol
Yucatán,531,429,2010,2,D3,102,frijol
Campeche,2560,1520,2010,3,D2,1040,frijol
Chiapas,44479,19403,2010,3,D2,25076,frijol
Guerrero,95,34,2010,3,NPS,61,frijol
Hidalgo,4719,4076,2010,3,NPS,643,frijol
Jalisco,1929,50,2010,3,NPS,1879,frijol
Nayarit,40381,36429,2010,3,NPS,3952,frijol
Oaxaca,2667,1423,2010,3,NPS,1244,frijol
Puebla,380,43,2010,3,NPS,337,frijol
Quintana Roo,2863,2737,2010,3,D1,126,frijol
San Luis Potosí,6449,3766,2010,3,NPS,2683,frijol
Sinaloa,3358,2997,2010,3,NPS,361,frijol
Sonora,95,95,2010,3,NPS,0,frijol
Tabasco,4665,2156,2010,3,D2,2509,frijol
Tamaulipas,973,116,2010,3,NPS,857,frijol
Veracruz de Ignacio de la Llave,23348,10129,2010,3,NPS,13219,frijol
Yucatán,531,459,2010,3,D2,72,frijol
Campeche,2560,2320,2010,4,D2,240,frijol
Chiapas,44479,31997,2010,4,D3,12482,frijol
Guerrero,95,95,2010,4,NPS,0,frijol
Hidalgo,4719,4076,2010,4,NPS,643,frijol
Jalisco,1929,1813,2010,4,NPS,116,frijol
Michoacán de Ocampo,65,48,2010,4,NPS,17,frijol
Nayarit,40381,36429,2010,4,NPS,3952,frijol
Oaxaca,2667,1798,2010,4,NPS,869,frijol
Puebla,380,43,2010,4,NPS,337,frijol
Quintana Roo,2863,2796,2010,4,D1,67,frijol
San Luis Potosí,6449,4313,2010,4,NPS,2136,frijol
Sinaloa,3358,3230,2010,4,NPS,128,frijol
Sonora,95,95,2010,4,NPS,0,frijol
Tabasco,4670,3716,2010,4,D3,954,frijol
Tamaulipas,973,568,2010,4,NPS,405,frijol
Veracruz de Ignacio de la Llave,23413,16926,2010,4,NPS,6487,frijol
Yucatán,531,459,2010,4,D3,72,frijol
Campeche,2560,2419,2010,5,D2,141,frijol
Chiapas,44479,37412,2010,5,D2,7067,frijol
Chihuahua,26,26,2010,5,NPS,0,frijol
Guerrero,95,95,2010,5,NPS,0,frijol
Hidalgo,4719,4341,2010,5,NPS,378,frijol
Jalisco,1929,1823,2010,5,NPS,106,frijol
Michoacán de Ocampo,65,65,2010,5,NPS,0,frijol
Nayarit,40381,37389,2010,5,NPS,2992,frijol
Oaxaca,2667,2479,2010,5,NPS,188,frijol
Puebla,380,47,2010,5,NPS,333,frijol
Quintana Roo,2863,2849,2010,5,D1,14,frijol
San Luis Potosí,6449,5154,2010,5,NPS,1295,frijol
Sinaloa,3358,3358,2010,5,D2,0,frijol
Sonora,95,95,2010,5,NPS,0,frijol
Tabasco,4770,4538,2010,5,D3,232,frijol
Tamaulipas,973,606,2010,5,NPS,367,frijol
Veracruz de Ignacio de la Llave,23413,21539,2010,5,NPS,1874,frijol
Yucatán,531,459,2010,5,D2,72,frijol
Campeche,2560,2424,2010,6,D2,136,frijol
Chiapas,44709,39675,2010,6,D2,5034,frijol
Chihuahua,26,26,2010,6,NPS,0,frijol
Guerrero,95,95,2010,6,NPS,0,frijol
Hidalgo,4719,4539,2010,6,NPS,180,frijol
Jalisco,1929,1889,2010,6,NPS,40,frijol
Michoacán de Ocampo,65,65,2010,6,NPS,0,frijol
Nayarit,40381,36543,2010,6,NPS,3838,frijol
Oaxaca,2667,2502,2010,6,NPS,165,frijol
Puebla,380,47,2010,6,NPS,333,frijol
Quintana Roo,2863,2857,2010,6,D1,6,frijol
San Luis Potosí,6449,5154,2010,6,NPS,1295,frijol
Sinaloa,3358,3358,2010,6,D2,0,frijol
Sonora,95,95,2010,6,NPS,0,frijol
Tabasco,4770,4678,2010,6,D2,92,frijol
Tamaulipas,973,606,2010,6,NPS,367,frijol
Veracruz de Ignacio de la Llave,23413,22030,2010,6,D0,1383,frijol
Yucatán,531,467,2010,6,D1,64,frijol
Campeche,2560,2424,2010,7,D0,136,frijol
Chiapas,44709,43388,2010,7,NPS,1321,frijol
Chihuahua,26,26,2010,7,NPS,0,frijol
Guerrero,95,95,2010,7,NPS,0,frijol
Hidalgo,4719,4719,2010,7,NPS,0,frijol
Jalisco,1929,1889,2010,7,NPS,40,frijol
Michoacán de Ocampo,65,65,2010,7,NPS,0,frijol
Nayarit,40381,36543,2010,7,NPS,3838,frijol
Oaxaca,2667,2502,2010,7,NPS,165,frijol
Puebla,380,107,2010,7,NPS,273,frijol
Quintana Roo,2863,2857,2010,7,D1,6,frijol
San Luis Potosí,6449,5154,2010,7,NPS,1295,frijol
Sinaloa,3358,3358,2010,7,NPS,0,frijol
Sonora,121,121,2010,7,NPS,0,frijol
Tabasco,4770,4678,2010,7,NPS,92,frijol
Tamaulipas,973,606,2010,7,NPS,367,frijol
Veracruz de Ignacio de la Llave,23413,22065,2010,7,NPS,1348,frijol
Yucatán,531,467,2010,7,D0,64,frijol
Campeche,2560,2504,2010,8,NPS,56,frijol
Chiapas,44709,44662,2010,8,NPS,47,frijol
Chihuahua,26,26,2010,8,NPS,0,frijol
Guerrero,95,95,2010,8,NPS,0,frijol
Hidalgo,4719,4719,2010,8,NPS,0,frijol
Jalisco,1929,1889,2010,8,NPS,40,frijol
Michoacán de Ocampo,65,65,2010,8,NPS,0,frijol
Nayarit,40381,36543,2010,8,NPS,3838,frijol
Oaxaca,2667,2502,2010,8,NPS,165,frijol
Puebla,380,363,2010,8,NPS,17,frijol
Quintana Roo,2863,2857,2010,8,NPS,6,frijol
San Luis Potosí,6449,5154,2010,8,NPS,1295,frijol
Sinaloa,3358,3358,2010,8,NPS,0,frijol
Sonora,121,121,2010,8,NPS,0,frijol
Tabasco,4770,4678,2010,8,NPS,92,frijol
Tamaulipas,973,973,2010,8,NPS,0,frijol
Veracruz de Ignacio de la Llave,23413,22145,2010,8,NPS,1268,frijol
Yucatán,782,718,2010,8,NPS,64,frijol
Campeche,2560,2504,2010,9,NPS,56,frijol
Chiapas,44709,44662,2010,9,NPS,47,frijol
Chihuahua,26,26,2010,9,NPS,0,frijol
Guerrero,95,95,2010,9,NPS,0,frijol
Hidalgo,4719,4719,2010,9,NPS,0,frijol
Jalisco,1929,1889,2010,9,NPS,40,frijol
Michoacán de Ocampo,65,65,2010,9,NPS,0,frijol
Nayarit,40381,36543,2010,9,NPS,3838,frijol
Oaxaca,2667,2502,2010,9,NPS,165,frijol
Puebla,380,366,2010,9,NPS,14,frijol
Quintana Roo,2863,2857,2010,9,NPS,6,frijol
San Luis Potosí,6449,5154,2010,9,NPS,1295,frijol
Sinaloa,3358,3358,2010,9,D0,0,frijol
Sonora,147,121,2010,9,NPS,26,frijol
Tabasco,4770,4678,2010,9,NPS,92,frijol
Tamaulipas,973,973,2010,9,NPS,0,frijol
Veracruz de Ignacio de la Llave,23413,22145,2010,9,NPS,1268,frijol
Yucatán,782,718,2010,9,NPS,64,frijol
Campeche,2560,2504,2010,12,NPS,56,frijol
Chiapas,44709,44662,2010,12,NPS,47,frijol
Chihuahua,26,26,2010,12,D0,0,frijol
Guerrero,95,95,2010,12,NPS,0,frijol
Hidalgo,4719,4719,2010,12,NPS,0,frijol
Jalisco,1929,1889,2010,12,NPS,40,frijol
Michoacán de Ocampo,65,65,2010,12,NPS,0,frijol
Nayarit,40381,36543,2010,12,NPS,3838,frijol
Oaxaca,2667,2502,2010,12,NPS,165,frijol
Puebla,380,366,2010,12,NPS,14,frijol
Quintana Roo,2863,2857,2010,12,NPS,6,frijol
San Luis Potosí,6449,5154,2010,12,NPS,1295,frijol
Sinaloa,3358,3358,2010,12,D0,0,frijol
Sonora,147,121,2010,12,D0,26,frijol
Tabasco,4770,4678,2010,12,NPS,92,frijol
Tamaulipas,973,973,2010,12,NPS,0,frijol
Veracruz de Ignacio de la Llave,23413,22145,2010,12,NPS,1268,frijol
Yucatán,782,718,2010,12,D0,64,frijol
Chiapas,42290,1833,2011,1,NPS,40457,frijol
Hidalgo,3894,3160,2011,1,NPS,734,frijol
Nayarit,39405,569,2011,1,D0,38836,frijol
Oaxaca,2633,437,2011,1,NPS,2196,frijol
Quintana Roo,3402,464,2011,1,NPS,2938,frijol
San Luis Potosí,4923,1610,2011,1,NPS,3313,frijol
Veracruz de Ignacio de la Llave,17478,17,2011,1,NPS,17461,frijol
Yucatán,280,176,2011,1,NPS,104,frijol
Campeche,2412,175,2011,2,D0,2237,frijol
Chiapas,43329,10100,2011,2,NPS,33229,frijol
Hidalgo,4262,3674,2011,2,NPS,588,frijol
Nayarit,39405,15531,2011,2,D0,23874,frijol
Oaxaca,2653,1017,2011,2,NPS,1636,frijol
Quintana Roo,3542,1843,2011,2,D0,1699,frijol
San Luis Potosí,5266,1610,2011,2,NPS,3656,frijol
Sinaloa,4101,23,2011,2,D0,4078,frijol
Tabasco,4861,746,2011,2,NPS,4115,frijol
Veracruz de Ignacio de la Llave,21044,2562,2011,2,NPS,18482,frijol
Yucatán,280,254,2011,2,D0,26,frijol
Campeche,2927,735,2011,3,D0,2192,frijol
Chiapas,43309,23780,2011,3,NPS,19529,frijol
Guerrero,95,44,2011,3,D0,51,frijol
Hidalgo,4334,3754,2011,3,D0,580,frijol
Jalisco,1988,85,2011,3,D0,1903,frijol
Nayarit,39425,39422,2011,3,D0,3,frijol
Oaxaca,2653,1750,2011,3,D1,903,frijol
Quintana Roo,3542,3078,2011,3,D0,464,frijol
San Luis Potosí,5280,2444,2011,3,D0,2836,frijol
Sinaloa,3446,23,2011,3,D2,3423,frijol
Tabasco,5111,3309,2011,3,NPS,1802,frijol
Tamaulipas,449,250,2011,3,D0,199,frijol
Veracruz de Ignacio de la Llave,21316,6632,2011,3,NPS,14684,frijol
Yucatán,280,254,2011,3,D0,26,frijol
Campeche,2927,1921,2011,4,D1,1006,frijol
Chiapas,43309,40696,2011,4,D1,2613,frijol
Guerrero,95,95,2011,4,D0,0,frijol
Hidalgo,4334,3754,2011,4,D2,580,frijol
Jalisco,1988,1834,2011,4,D2,154,frijol
Nayarit,39425,39248,2011,4,D2,177,frijol
Oaxaca,2653,2505,2011,4,D0,148,frijol
Quintana Roo,3542,3103,2011,4,D1,439,frijol
San Luis Potosí,5280,3787,2011,4,D2,1493,frijol
Sinaloa,3446,1078,2011,4,D2,2368,frijol
Tabasco,5111,4751,2011,4,D1,360,frijol
Tamaulipas,449,250,2011,4,D3,199,frijol
Veracruz de Ignacio de la Llave,21360,14813,2011,4,D1,6547,frijol
Yucatán,280,254,2011,4,D2,26,frijol
Campeche,2927,2826,2011,5,D3,101,frijol
Chiapas,43309,42474,2011,5,NPS,835,frijol
Guerrero,95,95,2011,5,D0,0,frijol
Hidalgo,4334,3754,2011,5,D2,580,frijol
Jalisco,1988,1988,2011,5,D2,0,frijol
Michoacán de Ocampo,93,60,2011,5,D1,33,frijol
Nayarit,39425,39248,2011,5,D2,177,frijol
Oaxaca,2653,2630,2011,5,D0,23,frijol
Puebla,347,43,2011,5,D1,304,frijol
Quintana Roo,3542,3103,2011,5,D2,439,frijol
San Luis Potosí,5280,3787,2011,5,D2,1493,frijol
Sinaloa,3446,1078,2011,5,D2,2368,frijol
Sonora,35,4,2011,5,D3,31,frijol
Tabasco,5111,5100,2011,5,D1,11,frijol
Tamaulipas,449,308,2011,5,D3,141,frijol
Veracruz de Ignacio de la Llave,21360,19562,2011,5,D1,1798,frijol
Yucatán,280,254,2011,5,D3,26,frijol
Campeche,2927,2876,2011,6,D2,51,frijol
Chiapas,43309,43309,2011,6,D0,0,frijol
Guerrero,95,95,2011,6,NPS,0,frijol
Hidalgo,4334,4124,2011,6,D2,210,frijol
Jalisco,1988,1988,2011,6,D2,0,frijol
Michoacán de Ocampo,93,60,2011,6,D3,33,frijol
Nayarit,39425,39248,2011,6,D2,177,frijol
Oaxaca,2653,2653,2011,6,NPS,0,frijol
Puebla,347,279,2011,6,D2,68,frijol
Quintana Roo,3542,3103,2011,6,D2,439,frijol
San Luis Potosí,5280,3787,2011,6,D2,1493,frijol
Sinaloa,3446,1078,2011,6,D2,2368,frijol
Sonora,35,4,2011,6,D3,31,frijol
Tabasco,5111,5111,2011,6,D1,0,frijol
Tamaulipas,449,308,2011,6,D2,141,frijol
Veracruz de Ignacio de la Llave,21792,19984,2011,6,D3,1808,frijol
Yucatán,280,278,2011,6,D2,2,frijol
Campeche,2927,2876,2011,7,D1,51,frijol
Chiapas,43309,43309,2011,7,NPS,0,frijol
Guerrero,95,95,2011,7,NPS,0,frijol
Hidalgo,4334,4334,2011,7,D1,0,frijol
Jalisco,1988,1988,2011,7,D2,0,frijol
Michoacán de Ocampo,93,60,2011,7,D2,33,frijol
Nayarit,39425,39248,2011,7,D2,177,frijol
Oaxaca,2653,2653,2011,7,NPS,0,frijol
Puebla,347,347,2011,7,D1,0,frijol
Quintana Roo,3542,3103,2011,7,D1,439,frijol
San Luis Potosí,5280,3787,2011,7,D2,1493,frijol
Sinaloa,3446,1078,2011,7,D1,2368,frijol
Sonora,35,16,2011,7,D3,19,frijol
Tabasco,5111,5111,2011,7,D1,0,frijol
Tamaulipas,449,308,2011,7,D1,141,frijol
Veracruz de Ignacio de la Llave,21792,19984,2011,7,D1,1808,frijol
Yucatán,280,278,2011,7,D1,2,frijol
Campeche,2927,2876,2011,8,D1,51,frijol
Chiapas,43309,43309,2011,8,NPS,0,frijol
Guerrero,95,95,2011,8,NPS,0,frijol
Hidalgo,4334,4334,2011,8,D1,0,frijol
Jalisco,1988,1988,2011,8,D2,0,frijol
Michoacán de Ocampo,93,60,2011,8,D2,33,frijol
Nayarit,39425,39248,2011,8,D1,177,frijol
Oaxaca,2653,2653,2011,8,NPS,0,frijol
Puebla,347,347,2011,8,D0,0,frijol
Quintana Roo,3542,3103,2011,8,NPS,439,frijol
San Luis Potosí,5280,3787,2011,8,D1,1493,frijol
Sinaloa,3446,1078,2011,8,D1,2368,frijol
Sonora,35,16,2011,8,D2,19,frijol
Tabasco,5111,5111,2011,8,D1,0,frijol
Tamaulipas,449,308,2011,8,D1,141,frijol
Veracruz de Ignacio de la Llave,21792,21191,2011,8,D1,601,frijol
Yucatán,280,278,2011,8,D1,2,frijol
Campeche,2927,2876,2011,9,NPS,51,frijol
Chiapas,43309,43309,2011,9,NPS,0,frijol
Guerrero,95,95,2011,9,NPS,0,frijol
Hidalgo,4334,4334,2011,9,NPS,0,frijol
Jalisco,1988,1988,2011,9,NPS,0,frijol
Michoacán de Ocampo,93,60,2011,9,D1,33,frijol
Nayarit,39425,39248,2011,9,NPS,177,frijol
Oaxaca,2653,2653,2011,9,NPS,0,frijol
Puebla,347,347,2011,9,NPS,0,frijol
Quintana Roo,3542,3103,2011,9,NPS,439,frijol
San Luis Potosí,5280,3787,2011,9,D2,1493,frijol
Sinaloa,3446,1078,2011,9,NPS,2368,frijol
Sonora,35,16,2011,9,D3,19,frijol
Tabasco,5111,5111,2011,9,NPS,0,frijol
Tamaulipas,449,308,2011,9,D1,141,frijol
Veracruz de Ignacio de la Llave,21792,21197,2011,9,NPS,595,frijol
Yucatán,280,278,2011,9,NPS,2,frijol
Campeche,2927,2876,2011,12,NPS,51,frijol
Chiapas,43309,43309,2011,12,NPS,0,frijol
Guerrero,95,95,2011,12,NPS,0,frijol
Hidalgo,4334,4334,2011,12,D0,0,frijol
Jalisco,1988,1988,2011,12,D0,0,frijol
Michoacán de Ocampo,93,60,2011,12,D0,33,frijol
Nayarit,39425,39248,2011,12,NPS,177,frijol
Oaxaca,2653,2653,2011,12,NPS,0,frijol
Puebla,347,347,2011,12,NPS,0,frijol
Quintana Roo,3542,3103,2011,12,NPS,439,frijol
San Luis Potosí,5280,3787,2011,12,D0,1493,frijol
Sinaloa,3446,1078,2011,12,D1,2368,frijol
Sonora,35,16,2011,12,D0,19,frijol
Tabasco,5111,5111,2011,12,NPS,0,frijol
Tamaulipas,449,308,2011,12,D0,141,frijol
Veracruz de Ignacio de la Llave,21792,21197,2011,12,D0,595,frijol
Yucatán,280,278,2011,12,NPS,2,frijol
Campeche,2489,480,2012,1,NPS,2009,frijol
Chiapas,40877,1418,2012,1,NPS,39459,frijol
Hidalgo,3910,3104,2012,1,D0,806,frijol
Quintana Roo,2944,641,2012,1,NPS,2303,frijol
Veracruz de Ignacio de la Llave,17969,528,2012,1,NPS,17441,frijol
Yucatán,468,216,2012,1,NPS,252,frijol
Campeche,2504,585,2012,2,NPS,1919,frijol
Chiapas,40741,5218,2012,2,NPS,35523,frijol
Hidalgo,4217,3636,2012,2,NPS,581,frijol
Jalisco,2077,590,2012,2,NPS,1487,frijol
Michoacán de Ocampo,63,41,2012,2,NPS,22,frijol
Nayarit,34738,26208,2012,2,D0,8530,frijol
Oaxaca,2956,972,2012,2,NPS,1984,frijol
Quintana Roo,3039,876,2012,2,NPS,2163,frijol
San Luis Potosí,2389,930,2012,2,NPS,1459,frijol
Sinaloa,2462,838,2012,2,D1,1624,frijol
Tabasco,4594,497,2012,2,NPS,4097,frijol
Veracruz de Ignacio de la Llave,18589,2084,2012,2,NPS,16505,frijol
Yucatán,468,404,2012,2,NPS,64,frijol
Campeche,2504,2220,2012,3,D0,284,frijol
Chiapas,41228,14671,2012,3,NPS,26557,frijol
Guerrero,34,28,2012,3,NPS,6,frijol
Hidalgo,4217,3709,2012,3,NPS,508,frijol
Jalisco,2077,1670,2012,3,NPS,407,frijol
Michoacán de Ocampo,63,52,2012,3,NPS,11,frijol
Nayarit,34738,34684,2012,3,D0,54,frijol
Oaxaca,2956,2104,2012,3,NPS,852,frijol
Quintana Roo,3203,2477,2012,3,NPS,726,frijol
San Luis Potosí,2389,930,2012,3,NPS,1459,frijol
Sinaloa,2573,2409,2012,3,D2,164,frijol
Tabasco,4733,1979,2012,3,NPS,2754,frijol
Veracruz de Ignacio de la Llave,19434,4852,2012,3,NPS,14582,frijol
Yucatán,469,469,2012,3,D0,0,frijol
Campeche,2504,2319,2012,4,NPS,185,frijol
Chiapas,41228,30036,2012,4,NPS,11192,frijol
Guerrero,89,89,2012,4,NPS,0,frijol
Hidalgo,4217,3709,2012,4,NPS,508,frijol
Jalisco,2077,2042,2012,4,NPS,35,frijol
Michoacán de Ocampo,63,63,2012,4,NPS,0,frijol
Nayarit,34738,34684,2012,4,D1,54,frijol
Oaxaca,2956,2724,2012,4,NPS,232,frijol
Quintana Roo,3203,2761,2012,4,NPS,442,frijol
San Luis Potosí,2389,2374,2012,4,NPS,15,frijol
Sinaloa,2573,2424,2012,4,D2,149,frijol
Tabasco,4661,3744,2012,4,NPS,917,frijol
Veracruz de Ignacio de la Llave,19434,9747,2012,4,NPS,9687,frijol
Yucatán,469,469,2012,4,NPS,0,frijol
Campeche,2504,2321,2012,5,NPS,183,frijol
Chiapas,44758,40191,2012,5,NPS,4567,frijol
Chihuahua,26,8,2012,5,D2,18,frijol
Guerrero,89,89,2012,5,NPS,0,frijol
Hidalgo,4217,4004,2012,5,NPS,213,frijol
Jalisco,2077,2077,2012,5,NPS,0,frijol
Michoacán de Ocampo,63,63,2012,5,NPS,0,frijol
Nayarit,34738,34684,2012,5,D1,54,frijol
Oaxaca,2956,2830,2012,5,NPS,126,frijol
Quintana Roo,3203,3172,2012,5,NPS,31,frijol
San Luis Potosí,2389,2389,2012,5,NPS,0,frijol
Sinaloa,2573,2424,2012,5,D0,149,frijol
Tabasco,4661,4344,2012,5,NPS,317,frijol
Tamaulipas,464,275,2012,5,NPS,189,frijol
Veracruz de Ignacio de la Llave,19434,18431,2012,5,NPS,1003,frijol
Yucatán,469,469,2012,5,NPS,0,frijol
Campeche,2504,2321,2012,6,NPS,183,frijol
Chiapas,44758,42508,2012,6,NPS,2250,frijol
Chihuahua,26,8,2012,6,D2,18,frijol
Guerrero,89,89,2012,6,NPS,0,frijol
Hidalgo,4217,4037,2012,6,NPS,180,frijol
Jalisco,2077,2077,2012,6,NPS,0,frijol
Michoacán de Ocampo,63,63,2012,6,NPS,0,frijol
Nayarit,34738,34684,2012,6,NPS,54,frijol
Oaxaca,2956,2894,2012,6,NPS,62,frijol
Quintana Roo,3203,3203,2012,6,NPS,0,frijol
San Luis Potosí,2389,2389,2012,6,NPS,0,frijol
Sinaloa,3703,2445,2012,6,NPS,1258,frijol
Sonora,77,42,2012,6,D1,35,frijol
Tabasco,4661,4414,2012,6,NPS,247,frijol
Tamaulipas,464,376,2012,6,NPS,88,frijol
Veracruz de Ignacio de la Llave,19434,18850,2012,6,NPS,584,frijol
Yucatán,469,469,2012,6,NPS,0,frijol
Campeche,2504,2441,2012,7,NPS,63,frijol
Chiapas,44758,43078,2012,7,NPS,1680,frijol
Chihuahua,26,8,2012,7,D1,18,frijol
Guerrero,89,89,2012,7,NPS,0,frijol
Hidalgo,4217,4217,2012,7,NPS,0,frijol
Jalisco,2077,2077,2012,7,NPS,0,frijol
Michoacán de Ocampo,63,63,2012,7,NPS,0,frijol
Nayarit,34738,34684,2012,7,NPS,54,frijol
Oaxaca,2956,2894,2012,7,NPS,62,frijol
Puebla,312,312,2012,7,NPS,0,frijol
Quintana Roo,3203,3203,2012,7,NPS,0,frijol
San Luis Potosí,2389,2389,2012,7,NPS,0,frijol
Sinaloa,3738,2445,2012,7,NPS,1293,frijol
Sonora,77,42,2012,7,D1,35,frijol
Tabasco,4661,4620,2012,7,NPS,41,frijol
Tamaulipas,464,449,2012,7,NPS,15,frijol
Veracruz de Ignacio de la Llave,19434,18858,2012,7,NPS,576,frijol
Yucatán,469,469,2012,7,NPS,0,frijol
Campeche,2504,2441,2012,8,NPS,63,frijol
Chiapas,44758,43078,2012,8,NPS,1680,frijol
Chihuahua,26,8,2012,8,D1,18,frijol
Guerrero,89,89,2012,8,NPS,0,frijol
Hidalgo,4217,4217,2012,8,NPS,0,frijol
Jalisco,2077,2077,2012,8,NPS,0,frijol
Michoacán de Ocampo,63,63,2012,8,NPS,0,frijol
Nayarit,34738,34684,2012,8,NPS,54,frijol
Oaxaca,2956,2894,2012,8,NPS,62,frijol
Puebla,312,312,2012,8,NPS,0,frijol
Quintana Roo,3203,3203,2012,8,NPS,0,frijol
San Luis Potosí,2389,2389,2012,8,NPS,0,frijol
Sinaloa,3738,2445,2012,8,NPS,1293,frijol
Sonora,77,42,2012,8,D1,35,frijol
Tabasco,4661,4620,2012,8,NPS,41,frijol
Tamaulipas,464,449,2012,8,NPS,15,frijol
Veracruz de Ignacio de la Llave,19434,18869,2012,8,NPS,565,frijol
Yucatán,469,469,2012,8,NPS,0,frijol
Campeche,2504,2441,2012,9,NPS,63,frijol
Chiapas,44758,44758,2012,9,NPS,0,frijol
Chihuahua,26,8,2012,9,D1,18,frijol
Guerrero,89,89,2012,9,NPS,0,frijol
Hidalgo,4217,4217,2012,9,NPS,0,frijol
Jalisco,2077,2077,2012,9,NPS,0,frijol
Michoacán de Ocampo,63,63,2012,9,NPS,0,frijol
Nayarit,34738,34684,2012,9,NPS,54,frijol
Oaxaca,2956,2894,2012,9,NPS,62,frijol
Puebla,312,312,2012,9,NPS,0,frijol
Quintana Roo,3203,3203,2012,9,NPS,0,frijol
San Luis Potosí,2389,2389,2012,9,NPS,0,frijol
Sinaloa,3738,2445,2012,9,NPS,1293,frijol
Sonora,77,42,2012,9,D1,35,frijol
Tabasco,4661,4620,2012,9,NPS,41,frijol
Tamaulipas,464,449,2012,9,NPS,15,frijol
Veracruz de Ignacio de la Llave,19434,18885,2012,9,NPS,549,frijol
Yucatán,469,469,2012,9,NPS,0,frijol
Campeche,2504,2441,2012,12,NPS,63,frijol
Chiapas,44758,44758,2012,12,NPS,0,frijol
Chihuahua,26,8,2012,12,NPS,18,frijol
Guerrero,89,89,2012,12,NPS,0,frijol
Hidalgo,4217,4217,2012,12,NPS,0,frijol
Jalisco,2077,2077,2012,12,NPS,0,frijol
Michoacán de Ocampo,63,63,2012,12,NPS,0,frijol
Nayarit,34738,34684,2012,12,NPS,54,frijol
Oaxaca,2956,2894,2012,12,NPS,62,frijol
Puebla,312,312,2012,12,NPS,0,frijol
Quintana Roo,3203,3203,2012,12,NPS,0,frijol
San Luis Potosí,2389,2389,2012,12,D0,0,frijol
Sinaloa,3738,2445,2012,12,NPS,1293,frijol
Sonora,77,42,2012,12,D1,35,frijol
Tabasco,4661,4620,2012,12,NPS,41,frijol
Tamaulipas,464,449,2012,12,NPS,15,frijol
Veracruz de Ignacio de la Llave,19434,18885,2012,12,NPS,549,frijol
Yucatán,469,469,2012,12,NPS,0,frijol
Campeche,2622,776,2013,1,NPS,1846,frijol
Chiapas,38493,294,2013,1,NPS,38199,frijol
Hidalgo,4415,2054,2013,1,NPS,2361,frijol
Nayarit,38447,1063,2013,1,NPS,37384,frijol
Oaxaca,2963,42,2013,1,NPS,2921,frijol
Quintana Roo,2024,800,2013,1,NPS,1224,frijol
Sinaloa,3769,1039,2013,1,NPS,2730,frijol
Veracruz de Ignacio de la Llave,19900,978,2013,1,NPS,18922,frijol
Yucatán,586,8,2013,1,NPS,578,frijol
Campeche,2622,962,2013,2,NPS,1660,frijol
Chiapas,39314,8275,2013,2,NPS,31039,frijol
Hidalgo,4638,4076,2013,2,NPS,562,frijol
Jalisco,1764,1513,2013,2,NPS,251,frijol
Nayarit,38447,31454,2013,2,D1,6993,frijol
Oaxaca,2977,483,2013,2,NPS,2494,frijol
Quintana Roo,2026,1290,2013,2,NPS,736,frijol
Sinaloa,4376,3167,2013,2,NPS,1209,frijol
Tabasco,4664,415,2013,2,D0,4249,frijol
Veracruz de Ignacio de la Llave,20413,2810,2013,2,NPS,17603,frijol
Yucatán,586,586,2013,2,NPS,0,frijol
Campeche,2622,2565,2013,3,NPS,57,frijol
Chiapas,39418,21450,2013,3,NPS,17968,frijol
Guerrero,123,15,2013,3,NPS,108,frijol
Hidalgo,4638,4154,2013,3,D0,484,frijol
Jalisco,1764,1598,2013,3,NPS,166,frijol
Nayarit,38447,38374,2013,3,D0,73,frijol
Oaxaca,2977,2052,2013,3,NPS,925,frijol
Quintana Roo,2026,1798,2013,3,NPS,228,frijol
San Luis Potosí,1676,140,2013,3,NPS,1536,frijol
Sinaloa,4376,3504,2013,3,NPS,872,frijol
Tabasco,4664,2126,2013,3,NPS,2538,frijol
Veracruz de Ignacio de la Llave,20413,5536,2013,3,NPS,14877,frijol
Yucatán,593,593,2013,3,NPS,0,frijol
Campeche,2622,2575,2013,4,D0,47,frijol
Chiapas,39436,31444,2013,4,D0,7992,frijol
Guerrero,123,23,2013,4,NPS,100,frijol
Hidalgo,4638,4154,2013,4,D0,484,frijol
Jalisco,1764,1664,2013,4,NPS,100,frijol
Michoacán de Ocampo,60,52,2013,4,NPS,8,frijol
Nayarit,38447,38374,2013,4,NPS,73,frijol
Oaxaca,2977,2727,2013,4,NPS,250,frijol
Quintana Roo,2026,1877,2013,4,NPS,149,frijol
San Luis Potosí,1676,1564,2013,4,D0,112,frijol
Sinaloa,4376,4195,2013,4,NPS,181,frijol
Tabasco,4664,3368,2013,4,D0,1296,frijol
Tamaulipas,740,681,2013,4,D0,59,frijol
Veracruz de Ignacio de la Llave,20883,18800,2013,4,NPS,2083,frijol
Yucatán,593,593,2013,4,NPS,0,frijol
Campeche,2622,2580,2013,5,NPS,42,frijol
Chiapas,39436,37011,2013,5,NPS,2425,frijol
Chihuahua,26,26,2013,5,D0,0,frijol
Guerrero,123,123,2013,5,NPS,0,frijol
Hidalgo,4638,4377,2013,5,D0,261,frijol
Jalisco,1764,1704,2013,5,NPS,60,frijol
Michoacán de Ocampo,60,60,2013,5,NPS,0,frijol
Nayarit,38447,38374,2013,5,D1,73,frijol
Oaxaca,2977,2931,2013,5,NPS,46,frijol
Quintana Roo,2026,1877,2013,5,D0,149,frijol
San Luis Potosí,1676,1568,2013,5,D0,108,frijol
Sinaloa,4378,4197,2013,5,D0,181,frijol
Tabasco,4664,4664,2013,5,NPS,0,frijol
Tamaulipas,740,689,2013,5,D0,51,frijol
Veracruz de Ignacio de la Llave,20883,20501,2013,5,NPS,382,frijol
Yucatán,593,593,2013,5,NPS,0,frijol
Campeche,2622,2580,2013,6,NPS,42,frijol
Chiapas,39436,38928,2013,6,NPS,508,frijol
Chihuahua,26,26,2013,6,D0,0,frijol
Guerrero,123,123,2013,6,NPS,0,frijol
Hidalgo,4638,4638,2013,6,NPS,0,frijol
Jalisco,1764,1764,2013,6,NPS,0,frijol
Michoacán de Ocampo,60,60,2013,6,NPS,0,frijol
Nayarit,38447,38374,2013,6,NPS,73,frijol
Oaxaca,2977,2977,2013,6,NPS,0,frijol
Puebla,365,134,2013,6,NPS,231,frijol
Quintana Roo,2026,1877,2013,6,NPS,149,frijol
San Luis Potosí,1676,1568,2013,6,D0,108,frijol
Sinaloa,4378,4197,2013,6,D0,181,frijol
Sonora,107,23,2013,6,D0,84,frijol
Tabasco,4664,4664,2013,6,NPS,0,frijol
Tamaulipas,740,718,2013,6,D0,22,frijol
Veracruz de Ignacio de la Llave,20883,20501,2013,6,NPS,382,frijol
Yucatán,593,593,2013,6,NPS,0,frijol
Campeche,2622,2580,2013,7,NPS,42,frijol
Chiapas,39436,39436,2013,7,NPS,0,frijol
Chihuahua,26,26,2013,7,NPS,0,frijol
Guerrero,123,123,2013,7,D0,0,frijol
Hidalgo,4638,4638,2013,7,NPS,0,frijol
Jalisco,1768,1768,2013,7,D0,0,frijol
Michoacán de Ocampo,60,60,2013,7,NPS,0,frijol
Nayarit,38447,38374,2013,7,D0,73,frijol
Oaxaca,2977,2977,2013,7,NPS,0,frijol
Puebla,365,332,2013,7,NPS,33,frijol
Quintana Roo,2026,1877,2013,7,NPS,149,frijol
San Luis Potosí,1676,1568,2013,7,D0,108,frijol
Sinaloa,4378,4197,2013,7,D0,181,frijol
Sonora,107,23,2013,7,D0,84,frijol
Tabasco,4664,4664,2013,7,NPS,0,frijol
Tamaulipas,740,718,2013,7,D1,22,frijol
Veracruz de Ignacio de la Llave,20883,20591,2013,7,NPS,292,frijol
Yucatán,593,593,2013,7,NPS,0,frijol
Campeche,2622,2580,2013,8,NPS,42,frijol
Chiapas,39436,39436,2013,8,NPS,0,frijol
Chihuahua,26,26,2013,8,NPS,0,frijol
Guerrero,123,123,2013,8,D0,0,frijol
Hidalgo,4638,4638,2013,8,NPS,0,frijol
Jalisco,1768,1768,2013,8,D0,0,frijol
Michoacán de Ocampo,60,60,2013,8,D0,0,frijol
Nayarit,38447,38374,2013,8,D0,73,frijol
Oaxaca,2977,2977,2013,8,NPS,0,frijol
Puebla,365,332,2013,8,NPS,33,frijol
Quintana Roo,2026,1877,2013,8,NPS,149,frijol
San Luis Potosí,1676,1568,2013,8,D0,108,frijol
Sinaloa,4378,4197,2013,8,D0,181,frijol
Sonora,107,23,2013,8,D0,84,frijol
Tabasco,4664,4664,2013,8,NPS,0,frijol
Tamaulipas,740,718,2013,8,NPS,22,frijol
Veracruz de Ignacio de la Llave,20883,20611,2013,8,NPS,272,frijol
Yucatán,593,593,2013,8,NPS,0,frijol
Campeche,2622,2580,2013,9,NPS,42,frijol
Chiapas,39436,39436,2013,9,NPS,0,frijol
Chihuahua,26,26,2013,9,NPS,0,frijol
Guerrero,123,123,2013,9,NPS,0,frijol
Hidalgo,4638,4638,2013,9,NPS,0,frijol
Jalisco,1768,1768,2013,9,NPS,0,frijol
Michoacán de Ocampo,60,60,2013,9,NPS,0,frijol
Nayarit,38447,38374,2013,9,D0,73,frijol
Oaxaca,2977,2977,2013,9,NPS,0,frijol
Puebla,365,332,2013,9,NPS,33,frijol
Quintana Roo,2026,1877,2013,9,NPS,149,frijol
San Luis Potosí,1676,1568,2013,9,NPS,108,frijol
Sinaloa,4378,4197,2013,9,NPS,181,frijol
Sonora,107,23,2013,9,NPS,84,frijol
Tabasco,4664,4664,2013,9,NPS,0,frijol
Tamaulipas,740,718,2013,9,NPS,22,frijol
Veracruz de Ignacio de la Llave,20883,20673,2013,9,NPS,210,frijol
Yucatán,593,593,2013,9,NPS,0,frijol
Campeche,2622,2580,2013,12,NPS,42,frijol
Chiapas,39436,39436,2013,12,NPS,0,frijol
Chihuahua,26,26,2013,12,NPS,0,frijol
Guerrero,123,123,2013,12,NPS,0,frijol
Hidalgo,4638,4638,2013,12,NPS,0,frijol
Jalisco,1768,1768,2013,12,NPS,0,frijol
Michoacán de Ocampo,60,60,2013,12,NPS,0,frijol
Nayarit,38447,38374,2013,12,NPS,73,frijol
Oaxaca,2977,2977,2013,12,NPS,0,frijol
Puebla,365,332,2013,12,NPS,33,frijol
Quintana Roo,2026,1877,2013,12,NPS,149,frijol
San Luis Potosí,1676,1568,2013,12,NPS,108,frijol
Sinaloa,4378,4197,2013,12,NPS,181,frijol
Sonora,107,23,2013,12,NPS,84,frijol
Tabasco,4664,4664,2013,12,NPS,0,frijol
Tamaulipas,740,718,2013,12,NPS,22,frijol
Veracruz de Ignacio de la Llave,20883,20673,2013,12,NPS,210,frijol
Yucatán,593,593,2013,12,NPS,0,frijol
Campeche,2930,267,2014,1,NPS,2663,frijol
Chiapas,40958,942,2014,1,NPS,40016,frijol
Nayarit,36055,328,2014,1,NPS,35727,frijol
Quintana Roo,1965,58,2014,1,NPS,1907,frijol
Sinaloa,3658,30,2014,1,NPS,3628,frijol
Veracruz de Ignacio de la Llave,20400,489,2014,1,NPS,19911,frijol
Campeche,2930,990,2014,2,NPS,1940,frijol
Chiapas,41161,8455,2014,2,NPS,32706,frijol
Hidalgo,3606,3278,2014,2,NPS,328,frijol
Jalisco,1736,602,2014,2,NPS,1134,frijol
Michoacán de Ocampo,194,13,2014,2,NPS,181,frijol
Nayarit,36055,23243,2014,2,NPS,12812,frijol
Oaxaca,3131,193,2014,2,NPS,2938,frijol
Quintana Roo,2357,840,2014,2,NPS,1517,frijol
San Luis Potosí,1334,96,2014,2,NPS,1238,frijol
Sinaloa,3658,1964,2014,2,D0,1694,frijol
Tabasco,4243,837,2014,2,NPS,3406,frijol
Veracruz de Ignacio de la Llave,22439,3989,2014,2,NPS,18450,frijol
Yucatán,551,4,2014,2,NPS,547,frijol
Campeche,2930,1115,2014,3,NPS,1815,frijol
Chiapas,41181,29267,2014,3,NPS,11914,frijol
Hidalgo,3734,3336,2014,3,NPS,398,frijol
Jalisco,1838,1442,2014,3,NPS,396,frijol
Michoacán de Ocampo,194,31,2014,3,NPS,163,frijol
Nayarit,36055,32870,2014,3,NPS,3185,frijol
Oaxaca,3239,1461,2014,3,NPS,1778,frijol
Quintana Roo,2368,1691,2014,3,NPS,677,frijol
San Luis Potosí,1360,802,2014,3,NPS,558,frijol
Sinaloa,4713,4104,2014,3,NPS,609,frijol
Tabasco,4546,1503,2014,3,NPS,3043,frijol
Veracruz de Ignacio de la Llave,22493,5678,2014,3,NPS,16815,frijol
Yucatán,551,510,2014,3,NPS,41,frijol
Campeche,2930,2737,2014,4,NPS,193,frijol
Chiapas,41181,37820,2014,4,NPS,3361,frijol
Chihuahua,47,32,2014,4,NPS,15,frijol
Guerrero,137,64,2014,4,NPS,73,frijol
Hidalgo,3734,3351,2014,4,NPS,383,frijol
Jalisco,1838,1662,2014,4,NPS,176,frijol
Michoacán de Ocampo,194,88,2014,4,NPS,106,frijol
Nayarit,36055,32870,2014,4,NPS,3185,frijol
Oaxaca,3239,2656,2014,4,NPS,583,frijol
Puebla,392,28,2014,4,NPS,364,frijol
Quintana Roo,2368,1960,2014,4,NPS,408,frijol
San Luis Potosí,1360,1315,2014,4,NPS,45,frijol
Sinaloa,4713,4104,2014,4,D0,609,frijol
Tabasco,4646,2836,2014,4,NPS,1810,frijol
Tamaulipas,1008,410,2014,4,NPS,598,frijol
Veracruz de Ignacio de la Llave,22493,14535,2014,4,NPS,7958,frijol
Yucatán,563,540,2014,4,NPS,23,frijol
Campeche,2930,2890,2014,5,NPS,40,frijol
Chiapas,41181,40076,2014,5,NPS,1105,frijol
Chihuahua,47,32,2014,5,D0,15,frijol
Guerrero,137,106,2014,5,NPS,31,frijol
Hidalgo,3734,3363,2014,5,NPS,371,frijol
Jalisco,1838,1720,2014,5,NPS,118,frijol
Michoacán de Ocampo,194,168,2014,5,NPS,26,frijol
Nayarit,36055,32871,2014,5,NPS,3184,frijol
Oaxaca,3239,3239,2014,5,NPS,0,frijol
Puebla,392,89,2014,5,NPS,303,frijol
Quintana Roo,2368,2069,2014,5,NPS,299,frijol
San Luis Potosí,1360,1315,2014,5,NPS,45,frijol
Sinaloa,4713,4104,2014,5,D0,609,frijol
Tabasco,4691,3684,2014,5,NPS,1007,frijol
Tamaulipas,1008,738,2014,5,NPS,270,frijol
Veracruz de Ignacio de la Llave,22493,21456,2014,5,NPS,1037,frijol
Yucatán,563,540,2014,5,NPS,23,frijol
Campeche,2930,2904,2014,6,NPS,26,frijol
Chiapas,41181,41181,2014,6,NPS,0,frijol
Chihuahua,47,32,2014,6,D0,15,frijol
Guerrero,137,137,2014,6,NPS,0,frijol
Hidalgo,3734,3450,2014,6,NPS,284,frijol
Jalisco,1838,1722,2014,6,NPS,116,frijol
Michoacán de Ocampo,194,186,2014,6,NPS,8,frijol
Nayarit,36055,32871,2014,6,NPS,3184,frijol
Oaxaca,3239,3239,2014,6,NPS,0,frijol
Puebla,392,276,2014,6,NPS,116,frijol
Quintana Roo,2368,2087,2014,6,NPS,281,frijol
San Luis Potosí,1360,1315,2014,6,NPS,45,frijol
Sinaloa,4713,4204,2014,6,D0,509,frijol
Sonora,120,120,2014,6,D2,0,frijol
Tabasco,4691,3734,2014,6,NPS,957,frijol
Tamaulipas,1008,738,2014,6,NPS,270,frijol
Veracruz de Ignacio de la Llave,22493,21679,2014,6,NPS,814,frijol
Yucatán,563,540,2014,6,NPS,23,frijol
Campeche,2930,2904,2014,7,NPS,26,frijol
Chiapas,41181,41181,2014,7,NPS,0,frijol
Chihuahua,47,32,2014,7,D0,15,frijol
Guerrero,137,137,2014,7,D0,0,frijol
Hidalgo,3734,3734,2014,7,NPS,0,frijol
Jalisco,1838,1722,2014,7,NPS,116,frijol
Michoacán de Ocampo,194,186,2014,7,NPS,8,frijol
Nayarit,36055,32871,2014,7,NPS,3184,frijol
Oaxaca,3239,3239,2014,7,NPS,0,frijol
Puebla,392,372,2014,7,NPS,20,frijol
Quintana Roo,2368,2087,2014,7,D0,281,frijol
San Luis Potosí,1360,1315,2014,7,NPS,45,frijol
Sinaloa,4713,4204,2014,7,NPS,509,frijol
Sonora,120,120,2014,7,D2,0,frijol
Tabasco,4691,3734,2014,7,NPS,957,frijol
Tamaulipas,1008,738,2014,7,NPS,270,frijol
Veracruz de Ignacio de la Llave,22493,22451,2014,7,NPS,42,frijol
Yucatán,563,540,2014,7,NPS,23,frijol
Campeche,2930,2904,2014,8,NPS,26,frijol
Chiapas,41181,41181,2014,8,NPS,0,frijol
Chihuahua,47,32,2014,8,D0,15,frijol
Guerrero,137,137,2014,8,D0,0,frijol
Hidalgo,3734,3734,2014,8,NPS,0,frijol
Jalisco,1838,1722,2014,8,NPS,116,frijol
Michoacán de Ocampo,194,186,2014,8,D0,8,frijol
Nayarit,36055,32871,2014,8,D0,3184,frijol
Oaxaca,3239,3239,2014,8,NPS,0,frijol
Puebla,392,391,2014,8,NPS,1,frijol
Quintana Roo,2368,2096,2014,8,D0,272,frijol
San Luis Potosí,1360,1315,2014,8,NPS,45,frijol
Sinaloa,4713,4204,2014,8,NPS,509,frijol
Sonora,120,120,2014,8,D1,0,frijol
Tabasco,4691,3734,2014,8,NPS,957,frijol
Tamaulipas,1008,758,2014,8,D0,250,frijol
Veracruz de Ignacio de la Llave,22493,22451,2014,8,NPS,42,frijol
Yucatán,563,540,2014,8,NPS,23,frijol
Campeche,2930,2904,2014,9,NPS,26,frijol
Chiapas,41181,41181,2014,9,NPS,0,frijol
Chihuahua,47,32,2014,9,NPS,15,frijol
Guerrero,137,137,2014,9,D0,0,frijol
Hidalgo,3734,3734,2014,9,NPS,0,frijol
Jalisco,1838,1722,2014,9,NPS,116,frijol
Michoacán de Ocampo,194,186,2014,9,D0,8,frijol
Nayarit,36055,32871,2014,9,D0,3184,frijol
Oaxaca,3239,3239,2014,9,NPS,0,frijol
Puebla,392,392,2014,9,NPS,0,frijol
Quintana Roo,2368,2096,2014,9,D0,272,frijol
San Luis Potosí,1360,1315,2014,9,NPS,45,frijol
Sinaloa,4713,4204,2014,9,NPS,509,frijol
Sonora,120,120,2014,9,NPS,0,frijol
Tabasco,4691,3734,2014,9,D0,957,frijol
Tamaulipas,1008,948,2014,9,NPS,60,frijol
Veracruz de Ignacio de la Llave,22493,22454,2014,9,NPS,39,frijol
Yucatán,563,540,2014,9,NPS,23,frijol
Campeche,2930,2904,2014,12,D0,26,frijol
Chiapas,41181,41181,2014,12,NPS,0,frijol
Chihuahua,47,32,2014,12,NPS,15,frijol
Guerrero,137,137,2014,12,NPS,0,frijol
Hidalgo,3734,3734,2014,12,NPS,0,frijol
Jalisco,1838,1722,2014,12,NPS,116,frijol
Michoacán de Ocampo,194,186,2014,12,NPS,8,frijol
Nayarit,36055,32871,2014,12,NPS,3184,frijol
Oaxaca,3239,3239,2014,12,NPS,0,frijol
Puebla,392,392,2014,12,NPS,0,frijol
Quintana Roo,2368,2096,2014,12,NPS,272,frijol
San Luis Potosí,1360,1315,2014,12,NPS,45,frijol
Sinaloa,4713,4204,2014,12,NPS,509,frijol
Sonora,120,120,2014,12,NPS,0,frijol
Tabasco,4691,3734,2014,12,NPS,957,frijol
Tamaulipas,1008,948,2014,12,NPS,60,frijol
Veracruz de Ignacio de la Llave,22493,22454,2014,12,NPS,39,frijol
Yucatán,563,540,2014,12,NPS,23,frijol
Campeche,1896,600,2015,1,NPS,1296,frijol
Hidalgo,3316,897,2015,1,NPS,2419,frijol
Oaxaca,3790,261,2015,1,NPS,3529,frijol
Quintana Roo,3287,100,2015,1,NPS,3187,frijol
San Luis Potosí,4346,191,2015,1,NPS,4155,frijol
Sinaloa,2234,295,2015,1,NPS,1939,frijol
Sonora,89,30,2015,1,NPS,59,frijol
Tamaulipas,864,73,2015,1,NPS,791,frijol
Veracruz de Ignacio de la Llave,19066,1174,2015,1,NPS,17892,frijol
Yucatán,527,159,2015,1,NPS,368,frijol
Campeche,2063,1698,2015,2,NPS,365,frijol
Chiapas,41403,6665,2015,2,NPS,34738,frijol
Guerrero,213,30,2015,2,NPS,183,frijol
Hidalgo,3477,3196,2015,2,NPS,281,frijol
Michoacán de Ocampo,62,20,2015,2,D0,42,frijol
Nayarit,32700,918,2015,2,NPS,31782,frijol
Oaxaca,3832,841,2015,2,NPS,2991,frijol
Quintana Roo,3810,527,2015,2,NPS,3283,frijol
San Luis Potosí,4346,966,2015,2,NPS,3380,frijol
Sinaloa,2237,432,2015,2,NPS,1805,frijol
Sonora,112,30,2015,2,NPS,82,frijol
Tabasco,3622,782,2015,2,NPS,2840,frijol
Tamaulipas,1290,392,2015,2,NPS,898,frijol
Veracruz de Ignacio de la Llave,22322,2418,2015,2,NPS,19904,frijol
Yucatán,552,442,2015,2,NPS,110,frijol
Campeche,2063,1880,2015,3,NPS,183,frijol
Chiapas,41419,22948,2015,3,NPS,18471,frijol
Guerrero,213,40,2015,3,NPS,173,frijol
Hidalgo,3655,3196,2015,3,NPS,459,frijol
Jalisco,1553,488,2015,3,NPS,1065,frijol
Michoacán de Ocampo,62,55,2015,3,NPS,7,frijol
Nayarit,34161,18906,2015,3,NPS,15255,frijol
Oaxaca,3832,2215,2015,3,NPS,1617,frijol
Quintana Roo,3863,1318,2015,3,NPS,2545,frijol
San Luis Potosí,4346,3610,2015,3,NPS,736,frijol
Sinaloa,2408,1906,2015,3,NPS,502,frijol
Sonora,112,30,2015,3,NPS,82,frijol
Tabasco,4414,2083,2015,3,NPS,2331,frijol
Tamaulipas,1411,684,2015,3,NPS,727,frijol
Veracruz de Ignacio de la Llave,22564,5646,2015,3,NPS,16918,frijol
Yucatán,552,482,2015,3,NPS,70,frijol
Campeche,2064,2056,2015,4,NPS,8,frijol
Chiapas,41419,38703,2015,4,NPS,2716,frijol
Guerrero,213,175,2015,4,D0,38,frijol
Hidalgo,3655,3354,2015,4,NPS,301,frijol
Jalisco,1553,865,2015,4,NPS,688,frijol
Michoacán de Ocampo,62,62,2015,4,NPS,0,frijol
Nayarit,34161,19394,2015,4,NPS,14767,frijol
Oaxaca,3832,3459,2015,4,NPS,373,frijol
Puebla,416,6,2015,4,NPS,410,frijol
Quintana Roo,3863,2413,2015,4,NPS,1450,frijol
San Luis Potosí,4346,4341,2015,4,NPS,5,frijol
Sinaloa,2408,1906,2015,4,NPS,502,frijol
Sonora,112,30,2015,4,NPS,82,frijol
Tabasco,4416,3322,2015,4,NPS,1094,frijol
Tamaulipas,1411,875,2015,4,NPS,536,frijol
Veracruz de Ignacio de la Llave,22564,13426,2015,4,NPS,9138,frijol
Yucatán,552,522,2015,4,NPS,30,frijol
Campeche,2064,2056,2015,5,NPS,8,frijol
Chiapas,41419,41419,2015,5,NPS,0,frijol
Chihuahua,44,44,2015,5,NPS,0,frijol
Guerrero,213,213,2015,5,NPS,0,frijol
Hidalgo,3655,3476,2015,5,NPS,179,frijol
Jalisco,1553,1543,2015,5,NPS,10,frijol
Michoacán de Ocampo,62,62,2015,5,NPS,0,frijol
Nayarit,34161,19840,2015,5,NPS,14321,frijol
Oaxaca,3832,3676,2015,5,NPS,156,frijol
Puebla,416,6,2015,5,NPS,410,frijol
Quintana Roo,3863,2978,2015,5,D0,885,frijol
San Luis Potosí,4346,4341,2015,5,NPS,5,frijol
Sinaloa,2408,2405,2015,5,NPS,3,frijol
Sonora,112,30,2015,5,NPS,82,frijol
Tabasco,4416,3694,2015,5,NPS,722,frijol
Tamaulipas,1411,875,2015,5,NPS,536,frijol
Veracruz de Ignacio de la Llave,22564,19036,2015,5,NPS,3528,frijol
Yucatán,552,522,2015,5,D0,30,frijol
Campeche,2064,2056,2015,6,NPS,8,frijol
Chiapas,41419,41419,2015,6,NPS,0,frijol
Chihuahua,44,44,2015,6,NPS,0,frijol
Guerrero,213,213,2015,6,NPS,0,frijol
Hidalgo,3655,3598,2015,6,NPS,57,frijol
Jalisco,1553,1543,2015,6,NPS,10,frijol
Michoacán de Ocampo,62,62,2015,6,NPS,0,frijol
Nayarit,34161,19840,2015,6,NPS,14321,frijol
Oaxaca,3832,3676,2015,6,NPS,156,frijol
Puebla,416,294,2015,6,NPS,122,frijol
Quintana Roo,3863,3563,2015,6,NPS,300,frijol
San Luis Potosí,4346,4341,2015,6,NPS,5,frijol
Sinaloa,2408,2405,2015,6,NPS,3,frijol
Sonora,112,53,2015,6,NPS,59,frijol
Tabasco,4416,4405,2015,6,NPS,11,frijol
Tamaulipas,1411,875,2015,6,NPS,536,frijol
Veracruz de Ignacio de la Llave,22564,22388,2015,6,NPS,176,frijol
Yucatán,552,522,2015,6,D0,30,frijol
Campeche,2064,2056,2015,7,D0,8,frijol
Chiapas,41419,41419,2015,7,D0,0,frijol
Chihuahua,44,44,2015,7,NPS,0,frijol
Guerrero,213,213,2015,7,D0,0,frijol
Hidalgo,3655,3655,2015,7,NPS,0,frijol
Jalisco,1553,1543,2015,7,NPS,10,frijol
Michoacán de Ocampo,62,62,2015,7,NPS,0,frijol
Nayarit,34161,19840,2015,7,D0,14321,frijol
Oaxaca,3832,3676,2015,7,NPS,156,frijol
Puebla,416,416,2015,7,NPS,0,frijol
Quintana Roo,3863,3563,2015,7,NPS,300,frijol
San Luis Potosí,4346,4341,2015,7,NPS,5,frijol
Sinaloa,2408,2405,2015,7,NPS,3,frijol
Sonora,112,53,2015,7,NPS,59,frijol
Tabasco,4416,4405,2015,7,D0,11,frijol
Tamaulipas,1411,1358,2015,7,NPS,53,frijol
Veracruz de Ignacio de la Llave,22564,22434,2015,7,NPS,130,frijol
Yucatán,552,522,2015,7,D0,30,frijol
Campeche,2064,2056,2015,8,D0,8,frijol
Chiapas,41419,41419,2015,8,D1,0,frijol
Chihuahua,44,44,2015,8,NPS,0,frijol
Guerrero,213,213,2015,8,D0,0,frijol
Hidalgo,3655,3655,2015,8,NPS,0,frijol
Jalisco,1553,1543,2015,8,NPS,10,frijol
Michoacán de Ocampo,62,62,2015,8,D0,0,frijol
Nayarit,34161,19840,2015,8,D0,14321,frijol
Oaxaca,3832,3676,2015,8,NPS,156,frijol
Puebla,416,416,2015,8,NPS,0,frijol
Quintana Roo,3863,3563,2015,8,NPS,300,frijol
San Luis Potosí,4346,4341,2015,8,NPS,5,frijol
Sinaloa,2408,2405,2015,8,NPS,3,frijol
Sonora,112,53,2015,8,NPS,59,frijol
Tabasco,4416,4405,2015,8,D1,11,frijol
Tamaulipas,1411,1358,2015,8,NPS,53,frijol
Veracruz de Ignacio de la Llave,22564,22468,2015,8,D0,96,frijol
Yucatán,552,522,2015,8,D1,30,frijol
Campeche,2064,2056,2015,9,D0,8,frijol
Chiapas,41419,41419,2015,9,D1,0,frijol
Chihuahua,44,44,2015,9,NPS,0,frijol
Guerrero,213,213,2015,9,D0,0,frijol
Hidalgo,3655,3655,2015,9,NPS,0,frijol
Jalisco,1553,1543,2015,9,D0,10,frijol
Michoacán de Ocampo,62,62,2015,9,D0,0,frijol
Nayarit,34161,19840,2015,9,D0,14321,frijol
Oaxaca,3832,3676,2015,9,NPS,156,frijol
Puebla,416,416,2015,9,NPS,0,frijol
Quintana Roo,3863,3563,2015,9,D0,300,frijol
San Luis Potosí,4346,4341,2015,9,NPS,5,frijol
Sinaloa,2408,2405,2015,9,NPS,3,frijol
Sonora,112,53,2015,9,NPS,59,frijol
Tabasco,4416,4405,2015,9,D1,11,frijol
Tamaulipas,1411,1358,2015,9,NPS,53,frijol
Veracruz de Ignacio de la Llave,22564,22506,2015,9,D0,58,frijol
Yucatán,552,552,2015,9,D1,0,frijol
Campeche,2064,2056,2015,12,NPS,8,frijol
Chiapas,41419,41419,2015,12,NPS,0,frijol
Chihuahua,44,44,2015,12,NPS,0,frijol
Guerrero,213,213,2015,12,NPS,0,frijol
Hidalgo,3655,3655,2015,12,NPS,0,frijol
Jalisco,1553,1543,2015,12,NPS,10,frijol
Michoacán de Ocampo,62,62,2015,12,D0,0,frijol
Nayarit,34161,19840,2015,12,NPS,14321,frijol
Oaxaca,3832,3676,2015,12,NPS,156,frijol
Puebla,416,416,2015,12,NPS,0,frijol
Quintana Roo,3863,3563,2015,12,NPS,300,frijol
San Luis Potosí,4346,4341,2015,12,NPS,5,frijol
Sinaloa,2408,2405,2015,12,NPS,3,frijol
Sonora,112,53,2015,12,NPS,59,frijol
Tabasco,4416,4405,2015,12,NPS,11,frijol
Tamaulipas,1411,1358,2015,12,NPS,53,frijol
Veracruz de Ignacio de la Llave,22564,22506,2015,12,NPS,58,frijol
Yucatán,552,552,2015,12,NPS,0,frijol
Campeche,2406,2256,2016,1,NPS,150,frijol
Chiapas,41364,847,2016,1,NPS,40517,frijol
Hidalgo,2762,1648,2016,1,NPS,1114,frijol
San Luis Potosí,1635,709,2016,1,NPS,926,frijol
Tamaulipas,505,180,2016,1,NPS,325,frijol
Veracruz de Ignacio de la Llave,18662,516,2016,1,NPS,18146,frijol
Campeche,2580,2390,2016,2,D0,190,frijol
Chiapas,41380,15872,2016,2,NPS,25508,frijol
Hidalgo,2762,2613,2016,2,NPS,149,frijol
Nayarit,34325,11812,2016,2,NPS,22513,frijol
Oaxaca,3130,153,2016,2,NPS,2977,frijol
Quintana Roo,3520,330,2016,2,NPS,3190,frijol
San Luis Potosí,1635,1340,2016,2,NPS,295,frijol
Sinaloa,1518,475,2016,2,NPS,1043,frijol
Tabasco,3283,150,2016,2,NPS,3133,frijol
Tamaulipas,511,469,2016,2,NPS,42,frijol
Veracruz de Ignacio de la Llave,21056,5837,2016,2,D0,15219,frijol
Yucatán,526,45,2016,2,D0,481,frijol
Campeche,2580,2390,2016,3,NPS,190,frijol
Chiapas,41380,28645,2016,3,NPS,12735,frijol
Guerrero,231,115,2016,3,D1,116,frijol
Hidalgo,2882,2613,2016,3,D0,269,frijol
Nayarit,34325,33508,2016,3,NPS,817,frijol
Oaxaca,3130,1505,2016,3,NPS,1625,frijol
Quintana Roo,3858,1340,2016,3,NPS,2518,frijol
San Luis Potosí,1635,1632,2016,3,NPS,3,frijol
Sinaloa,1518,1416,2016,3,NPS,102,frijol
Tabasco,3535,1722,2016,3,NPS,1813,frijol
Tamaulipas,511,508,2016,3,NPS,3,frijol
Veracruz de Ignacio de la Llave,21952,6724,2016,3,D0,15228,frijol
Yucatán,526,248,2016,3,D0,278,frijol
Campeche,2580,2564,2016,4,D0,16,frijol
Chiapas,41380,39522,2016,4,D0,1858,frijol
Guerrero,231,177,2016,4,NPS,54,frijol
Hidalgo,2882,2775,2016,4,D0,107,frijol
Jalisco,1761,885,2016,4,NPS,876,frijol
Nayarit,34325,33508,2016,4,NPS,817,frijol
Oaxaca,3130,2953,2016,4,NPS,177,frijol
Puebla,397,51,2016,4,NPS,346,frijol
Quintana Roo,3864,1530,2016,4,NPS,2334,frijol
San Luis Potosí,1635,1632,2016,4,NPS,3,frijol
Sinaloa,1518,1518,2016,4,D0,0,frijol
Tabasco,3535,3290,2016,4,D0,245,frijol
Tamaulipas,511,511,2016,4,NPS,0,frijol
Veracruz de Ignacio de la Llave,21953,12444,2016,4,D0,9509,frijol
Yucatán,526,380,2016,4,D0,146,frijol
Campeche,2580,2564,2016,5,D1,16,frijol
Chiapas,41380,41168,2016,5,NPS,212,frijol
Chihuahua,26,26,2016,5,D0,0,frijol
Guerrero,231,212,2016,5,NPS,19,frijol
Hidalgo,2882,2876,2016,5,NPS,6,frijol
Jalisco,1761,1215,2016,5,D0,546,frijol
Nayarit,34325,33508,2016,5,NPS,817,frijol
Oaxaca,3130,3130,2016,5,NPS,0,frijol
Puebla,397,319,2016,5,NPS,78,frijol
Quintana Roo,3864,2078,2016,5,NPS,1786,frijol
San Luis Potosí,1635,1632,2016,5,D0,3,frijol
Sinaloa,1518,1518,2016,5,D0,0,frijol
Tabasco,3535,3490,2016,5,D0,45,frijol
Tamaulipas,511,511,2016,5,NPS,0,frijol
Veracruz de Ignacio de la Llave,21953,19264,2016,5,D0,2689,frijol
Yucatán,526,405,2016,5,D0,121,frijol
Campeche,2580,2564,2016,6,D1,16,frijol
Chiapas,41380,41362,2016,6,D0,18,frijol
Chihuahua,26,26,2016,6,D0,0,frijol
Guerrero,231,231,2016,6,NPS,0,frijol
Hidalgo,2882,2880,2016,6,NPS,2,frijol
Jalisco,1761,1761,2016,6,D0,0,frijol
Nayarit,34325,33508,2016,6,NPS,817,frijol
Oaxaca,3130,3130,2016,6,NPS,0,frijol
Puebla,397,331,2016,6,NPS,66,frijol
Quintana Roo,3864,3320,2016,6,D0,544,frijol
San Luis Potosí,1635,1632,2016,6,D0,3,frijol
Sinaloa,1518,1518,2016,6,D0,0,frijol
Tabasco,3535,3490,2016,6,D1,45,frijol
Tamaulipas,511,511,2016,6,NPS,0,frijol
Veracruz de Ignacio de la Llave,21953,21180,2016,6,D1,773,frijol
Yucatán,526,485,2016,6,D0,41,frijol
Campeche,2580,2564,2016,7,D0,16,frijol
Chiapas,41380,41362,2016,7,D0,18,frijol
Chihuahua,26,26,2016,7,D0,0,frijol
Guerrero,231,231,2016,7,D0,0,frijol
Hidalgo,2882,2880,2016,7,NPS,2,frijol
Jalisco,1761,1761,2016,7,D0,0,frijol
Nayarit,34325,33508,2016,7,D0,817,frijol
Oaxaca,3130,3130,2016,7,D0,0,frijol
Puebla,397,388,2016,7,NPS,9,frijol
Quintana Roo,3864,3646,2016,7,D0,218,frijol
San Luis Potosí,1635,1632,2016,7,D0,3,frijol
Sinaloa,1518,1518,2016,7,D0,0,frijol
Sonora,47,15,2016,7,D0,32,frijol
Tabasco,3535,3490,2016,7,D1,45,frijol
Tamaulipas,511,511,2016,7,NPS,0,frijol
Veracruz de Ignacio de la Llave,21953,21726,2016,7,D0,227,frijol
Yucatán,526,485,2016,7,D1,41,frijol
Campeche,2580,2564,2016,8,NPS,16,frijol
Chiapas,41380,41362,2016,8,D0,18,frijol
Chihuahua,26,26,2016,8,NPS,0,frijol
Guerrero,231,231,2016,8,D1,0,frijol
Hidalgo,2882,2882,2016,8,NPS,0,frijol
Jalisco,1761,1761,2016,8,D0,0,frijol
Nayarit,34325,33508,2016,8,D0,817,frijol
Oaxaca,3130,3130,2016,8,NPS,0,frijol
Puebla,397,397,2016,8,NPS,0,frijol
Quintana Roo,3864,3646,2016,8,D1,218,frijol
San Luis Potosí,1635,1632,2016,8,D1,3,frijol
Sinaloa,1518,1518,2016,8,D0,0,frijol
Sonora,47,15,2016,8,NPS,32,frijol
Tabasco,3535,3490,2016,8,D0,45,frijol
Tamaulipas,511,511,2016,8,D0,0,frijol
Veracruz de Ignacio de la Llave,21953,21820,2016,8,NPS,133,frijol
Yucatán,526,526,2016,8,D0,0,frijol
Campeche,2580,2564,2016,9,NPS,16,frijol
Chiapas,41380,41362,2016,9,NPS,18,frijol
Chihuahua,26,26,2016,9,NPS,0,frijol
Guerrero,231,231,2016,9,NPS,0,frijol
Hidalgo,2882,2882,2016,9,NPS,0,frijol
Jalisco,1761,1761,2016,9,NPS,0,frijol
Nayarit,34325,33508,2016,9,NPS,817,frijol
Oaxaca,3130,3130,2016,9,D0,0,frijol
Puebla,397,397,2016,9,NPS,0,frijol
Quintana Roo,3864,3646,2016,9,D1,218,frijol
San Luis Potosí,1635,1632,2016,9,NPS,3,frijol
Sinaloa,1518,1518,2016,9,NPS,0,frijol
Sonora,47,15,2016,9,NPS,32,frijol
Tabasco,3535,3490,2016,9,D1,45,frijol
Tamaulipas,511,511,2016,9,D0,0,frijol
Veracruz de Ignacio de la Llave,21953,21927,2016,9,NPS,26,frijol
Yucatán,526,526,2016,9,D0,0,frijol
Campeche,2580,2564,2016,12,D1,16,frijol
Chiapas,41380,41362,2016,12,D0,18,frijol
Chihuahua,26,26,2016,12,NPS,0,frijol
Guerrero,231,231,2016,12,D1,0,frijol
Hidalgo,2882,2882,2016,12,NPS,0,frijol
Jalisco,1761,1761,2016,12,NPS,0,frijol
Nayarit,34325,33508,2016,12,NPS,817,frijol
Oaxaca,3130,3130,2016,12,D0,0,frijol
Puebla,397,397,2016,12,NPS,0,frijol
Quintana Roo,3864,3646,2016,12,D1,218,frijol
San Luis Potosí,1635,1632,2016,12,NPS,3,frijol
Sinaloa,1518,1518,2016,12,D0,0,frijol
Sonora,47,15,2016,12,D0,32,frijol
Tabasco,3535,3490,2016,12,D1,45,frijol
Tamaulipas,511,511,2016,12,NPS,0,frijol
Veracruz de Ignacio de la Llave,21953,21927,2016,12,NPS,26,frijol
Yucatán,526,526,2016,12,D1,0,frijol
Campeche,2095,1747,2017,1,D0,348,frijol
Hidalgo,3041,803,2017,1,NPS,2238,frijol
San Luis Potosí,1605,745,2017,1,NPS,860,frijol
Campeche,2095,1885,2017,2,D0,210,frijol
Chiapas,41487,12472,2017,2,NPS,29015,frijol
Guerrero,388,138,2017,2,D1,250,frijol
Hidalgo,3139,2300,2017,2,NPS,839,frijol
Nayarit,38505,12333,2017,2,NPS,26172,frijol
Oaxaca,3033,411,2017,2,D0,2622,frijol
San Luis Potosí,1605,1443,2017,2,D0,162,frijol
Sinaloa,865,32,2017,2,D0,833,frijol
Tabasco,2778,566,2017,2,D2,2212,frijol
Tamaulipas,304,184,2017,2,D0,120,frijol
Veracruz de Ignacio de la Llave,23269,6234,2017,2,NPS,17035,frijol
Yucatán,513,266,2017,2,NPS,247,frijol
Campeche,2096,2060,2017,3,D1,36,frijol
Chiapas,41487,35312,2017,3,NPS,6175,frijol
Guerrero,388,224,2017,3,D1,164,frijol
Hidalgo,3146,2350,2017,3,NPS,796,frijol
Nayarit,38505,30426,2017,3,NPS,8079,frijol
Oaxaca,3033,1877,2017,3,D0,1156,frijol
Quintana Roo,2045,890,2017,3,NPS,1155,frijol
San Luis Potosí,1605,1605,2017,3,D0,0,frijol
Sinaloa,865,52,2017,3,D0,813,frijol
Tabasco,2810,1165,2017,3,D2,1645,frijol
Tamaulipas,304,201,2017,3,NPS,103,frijol
Veracruz de Ignacio de la Llave,23272,8049,2017,3,NPS,15223,frijol
Yucatán,513,513,2017,3,D1,0,frijol
Campeche,2096,2060,2017,4,D1,36,frijol
Chiapas,41487,40888,2017,4,NPS,599,frijol
Guerrero,388,388,2017,4,D1,0,frijol
Hidalgo,3146,2350,2017,4,D0,796,frijol
Jalisco,1658,781,2017,4,D0,877,frijol
Nayarit,38505,37259,2017,4,NPS,1246,frijol
Oaxaca,3033,2648,2017,4,NPS,385,frijol
Quintana Roo,2045,890,2017,4,NPS,1155,frijol
San Luis Potosí,1605,1605,2017,4,D1,0,frijol
Sinaloa,1414,52,2017,4,D0,1362,frijol
Tabasco,2810,2444,2017,4,D1,366,frijol
Tamaulipas,304,288,2017,4,NPS,16,frijol
Veracruz de Ignacio de la Llave,23272,13329,2017,4,NPS,9943,frijol
Yucatán,513,513,2017,4,D0,0,frijol
Campeche,2096,2082,2017,5,D0,14,frijol
Chiapas,41487,41487,2017,5,NPS,0,frijol
Guerrero,388,388,2017,5,D0,0,frijol
Hidalgo,3146,2747,2017,5,D0,399,frijol
Jalisco,1658,1301,2017,5,D0,357,frijol
Nayarit,38505,37259,2017,5,NPS,1246,frijol
Oaxaca,3033,3003,2017,5,NPS,30,frijol
Puebla,143,68,2017,5,NPS,75,frijol
Quintana Roo,2045,1484,2017,5,NPS,561,frijol
San Luis Potosí,1605,1605,2017,5,D0,0,frijol
Sinaloa,1414,865,2017,5,D0,549,frijol
Tabasco,2810,2746,2017,5,D1,64,frijol
Tamaulipas,304,294,2017,5,NPS,10,frijol
Veracruz de Ignacio de la Llave,23272,18472,2017,5,NPS,4800,frijol
Yucatán,513,513,2017,5,D0,0,frijol
Campeche,2096,2082,2017,6,D0,14,frijol
Chiapas,41487,41487,2017,6,D0,0,frijol
Guerrero,388,388,2017,6,NPS,0,frijol
Hidalgo,3146,2747,2017,6,D0,399,frijol
Jalisco,1658,1658,2017,6,D1,0,frijol
Nayarit,38505,37381,2017,6,D0,1124,frijol
Oaxaca,3033,3003,2017,6,NPS,30,frijol
Puebla,143,112,2017,6,NPS,31,frijol
Quintana Roo,2045,1908,2017,6,D0,137,frijol
San Luis Potosí,1605,1605,2017,6,D1,0,frijol
Sinaloa,1414,1414,2017,6,D0,0,frijol
Sonora,14,14,2017,6,D0,0,frijol
Tabasco,2810,2746,2017,6,D0,64,frijol
Tamaulipas,304,294,2017,6,D0,10,frijol
Veracruz de Ignacio de la Llave,23272,21932,2017,6,D0,1340,frijol
Yucatán,513,513,2017,6,D0,0,frijol
Campeche,2096,2082,2017,7,NPS,14,frijol
Chiapas,41487,41487,2017,7,D0,0,frijol
Guerrero,388,388,2017,7,D0,0,frijol
Hidalgo,3146,3146,2017,7,D0,0,frijol
Jalisco,1658,1658,2017,7,D1,0,frijol
Nayarit,38505,37381,2017,7,D1,1124,frijol
Oaxaca,3033,3003,2017,7,NPS,30,frijol
Puebla,143,143,2017,7,NPS,0,frijol
Quintana Roo,2045,1908,2017,7,D0,137,frijol
San Luis Potosí,1605,1605,2017,7,D1,0,frijol
Sinaloa,1414,1414,2017,7,D1,0,frijol
Sonora,14,14,2017,7,NPS,0,frijol
Tabasco,2810,2746,2017,7,D0,64,frijol
Tamaulipas,304,294,2017,7,D0,10,frijol
Veracruz de Ignacio de la Llave,23272,22124,2017,7,D0,1148,frijol
Yucatán,513,513,2017,7,NPS,0,frijol
Campeche,2096,2082,2017,8,NPS,14,frijol
Chiapas,41487,41487,2017,8,D0,0,frijol
Guerrero,388,388,2017,8,D0,0,frijol
Hidalgo,3146,3146,2017,8,NPS,0,frijol
Jalisco,1658,1658,2017,8,NPS,0,frijol
Nayarit,38505,37381,2017,8,D1,1124,frijol
Oaxaca,3033,3003,2017,8,NPS,30,frijol
Puebla,143,143,2017,8,NPS,0,frijol
Quintana Roo,2045,1908,2017,8,NPS,137,frijol
San Luis Potosí,1605,1605,2017,8,D1,0,frijol
Sinaloa,1414,1414,2017,8,D0,0,frijol
Sonora,14,14,2017,8,NPS,0,frijol
Tabasco,2810,2746,2017,8,D0,64,frijol
Tamaulipas,304,294,2017,8,D0,10,frijol
Veracruz de Ignacio de la Llave,23272,22190,2017,8,NPS,1082,frijol
Yucatán,513,513,2017,8,NPS,0,frijol
Campeche,2096,2082,2017,9,NPS,14,frijol
Chiapas,41487,41487,2017,9,D0,0,frijol
Guerrero,388,388,2017,9,NPS,0,frijol
Hidalgo,3146,3146,2017,9,NPS,0,frijol
Jalisco,1658,1658,2017,9,NPS,0,frijol
Nayarit,38505,37381,2017,9,NPS,1124,frijol
Oaxaca,3033,3003,2017,9,NPS,30,frijol
Puebla,143,143,2017,9,NPS,0,frijol
Quintana Roo,2045,1908,2017,9,NPS,137,frijol
San Luis Potosí,1605,1605,2017,9,D0,0,frijol
Sinaloa,1414,1414,2017,9,D0,0,frijol
Sonora,14,14,2017,9,NPS,0,frijol
Tabasco,2810,2746,2017,9,D0,64,frijol
Tamaulipas,304,294,2017,9,D0,10,frijol
Veracruz de Ignacio de la Llave,23272,23134,2017,9,NPS,138,frijol
Yucatán,513,513,2017,9,NPS,0,frijol
Campeche,2096,2082,2017,12,NPS,14,frijol
Chiapas,41487,41487,2017,12,D0,0,frijol
Guerrero,388,388,2017,12,NPS,0,frijol
Hidalgo,3146,3146,2017,12,NPS,0,frijol
Jalisco,1658,1658,2017,12,D0,0,frijol
Nayarit,38505,37381,2017,12,D0,1124,frijol
Oaxaca,3033,3003,2017,12,NPS,30,frijol
Puebla,143,143,2017,12,NPS,0,frijol
Quintana Roo,2045,1908,2017,12,NPS,137,frijol
San Luis Potosí,1605,1605,2017,12,D0,0,frijol
Sinaloa,1414,1414,2017,12,D1,0,frijol
Sonora,14,14,2017,12,D1,0,frijol
Tabasco,2810,2746,2017,12,D0,64,frijol
Tamaulipas,304,294,2017,12,D0,10,frijol
Veracruz de Ignacio de la Llave,23272,23134,2017,12,NPS,138,frijol
Yucatán,513,513,2017,12,NPS,0,frijol
Campeche,1560,1028,2018,1,NPS,532,frijol
Chiapas,41103,2500,2018,1,D0,38603,frijol
Hidalgo,1852,1315,2018,1,NPS,537,frijol
Nayarit,52691,424,2018,1,D0,52267,frijol
San Luis Potosí,984,196,2018,1,NPS,788,frijol
Tamaulipas,228,150,2018,1,NPS,78,frijol
Veracruz de Ignacio de la Llave,16507,1578,2018,1,NPS,14929,frijol
Campeche,1560,1522,2018,2,NPS,38,frijol
Chiapas,41220,16142,2018,2,NPS,25078,frijol
Guerrero,456,227,2018,2,D0,229,frijol
Hidalgo,1923,1750,2018,2,NPS,173,frijol
Nayarit,52691,23338,2018,2,D0,29353,frijol
Oaxaca,3026,412,2018,2,NPS,2614,frijol
Quintana Roo,1426,320,2018,2,NPS,1106,frijol
San Luis Potosí,984,863,2018,2,D0,121,frijol
Sinaloa,1242,865,2018,2,D1,377,frijol
Tabasco,2794,488,2018,2,NPS,2306,frijol
Tamaulipas,228,171,2018,2,NPS,57,frijol
Veracruz de Ignacio de la Llave,18927,5435,2018,2,NPS,13492,frijol
Campeche,1560,1544,2018,3,NPS,16,frijol
Chiapas,41229,35395,2018,3,D0,5834,frijol
Guerrero,456,234,2018,3,D0,222,frijol
Hidalgo,2302,1750,2018,3,NPS,552,frijol
Nayarit,52691,52691,2018,3,D0,0,frijol
Oaxaca,3026,1812,2018,3,NPS,1214,frijol
Quintana Roo,1666,1372,2018,3,NPS,294,frijol
San Luis Potosí,984,920,2018,3,D0,64,frijol
Sinaloa,1242,1224,2018,3,D2,18,frijol
Tabasco,2998,1282,2018,3,D0,1716,frijol
Tamaulipas,308,179,2018,3,NPS,129,frijol
Veracruz de Ignacio de la Llave,19689,7376,2018,3,NPS,12313,frijol
Campeche,1560,1544,2018,4,NPS,16,frijol
Chiapas,41229,40674,2018,4,NPS,555,frijol
Guerrero,456,456,2018,4,D1,0,frijol
Hidalgo,2302,1801,2018,4,NPS,501,frijol
Jalisco,1704,755,2018,4,D1,949,frijol
Nayarit,52691,52691,2018,4,D1,0,frijol
Nuevo León,84,84,2018,4,D0,0,frijol
Oaxaca,3026,2790,2018,4,NPS,236,frijol
Quintana Roo,1666,1655,2018,4,NPS,11,frijol
San Luis Potosí,984,928,2018,4,NPS,56,frijol
Sinaloa,1242,1242,2018,4,D2,0,frijol
Tabasco,2998,2547,2018,4,D0,451,frijol
Tamaulipas,308,192,2018,4,NPS,116,frijol
Veracruz de Ignacio de la Llave,19689,12664,2018,4,NPS,7025,frijol
Yucatán,436,200,2018,4,D0,236,frijol
Campeche,1560,1544,2018,5,NPS,16,frijol
Chiapas,41229,41229,2018,5,NPS,0,frijol
Guerrero,456,456,2018,5,D1,0,frijol
Hidalgo,2302,1960,2018,5,NPS,342,frijol
Jalisco,1704,1580,2018,5,D0,124,frijol
Nayarit,52691,52691,2018,5,D1,0,frijol
Nuevo León,84,84,2018,5,NPS,0,frijol
Oaxaca,3026,3026,2018,5,NPS,0,frijol
Puebla,98,70,2018,5,NPS,28,frijol
Quintana Roo,1666,1666,2018,5,NPS,0,frijol
San Luis Potosí,984,928,2018,5,NPS,56,frijol
Sinaloa,1242,1242,2018,5,D2,0,frijol
Sonora,60,60,2018,5,D3,0,frijol
Tabasco,2998,2784,2018,5,D0,214,frijol
Tamaulipas,308,192,2018,5,NPS,116,frijol
Veracruz de Ignacio de la Llave,19689,14431,2018,5,NPS,5258,frijol
Yucatán,436,436,2018,5,NPS,0,frijol
Campeche,1560,1544,2018,6,NPS,16,frijol
Chiapas,41229,41229,2018,6,D0,0,frijol
Guerrero,456,456,2018,6,NPS,0,frijol
Hidalgo,2302,2002,2018,6,D0,300,frijol
Jalisco,1704,1704,2018,6,NPS,0,frijol
Nayarit,52691,52691,2018,6,D0,0,frijol
Nuevo León,84,84,2018,6,NPS,0,frijol
Oaxaca,3026,3026,2018,6,NPS,0,frijol
Puebla,98,78,2018,6,NPS,20,frijol
Quintana Roo,1666,1666,2018,6,NPS,0,frijol
San Luis Potosí,984,928,2018,6,D0,56,frijol
Sinaloa,1242,1242,2018,6,D1,0,frijol
Sonora,60,60,2018,6,D3,0,frijol
Tabasco,2998,2784,2018,6,D0,214,frijol
Tamaulipas,308,242,2018,6,NPS,66,frijol
Veracruz de Ignacio de la Llave,19689,18818,2018,6,NPS,871,frijol
Yucatán,436,436,2018,6,NPS,0,frijol
Campeche,1560,1544,2018,7,D0,16,frijol
Chiapas,41229,41229,2018,7,D0,0,frijol
Guerrero,456,456,2018,7,D0,0,frijol
Hidalgo,2302,2002,2018,7,D0,300,frijol
Jalisco,1704,1704,2018,7,NPS,0,frijol
Nayarit,52691,52691,2018,7,D0,0,frijol
Nuevo León,84,84,2018,7,NPS,0,frijol
Oaxaca,3026,3026,2018,7,D0,0,frijol
Puebla,98,98,2018,7,NPS,0,frijol
Quintana Roo,1666,1666,2018,7,NPS,0,frijol
San Luis Potosí,984,928,2018,7,D0,56,frijol
Sinaloa,1242,1242,2018,7,D1,0,frijol
Sonora,60,60,2018,7,D2,0,frijol
Tabasco,2998,2784,2018,7,D1,214,frijol
Tamaulipas,308,251,2018,7,NPS,57,frijol
Veracruz de Ignacio de la Llave,19689,19290,2018,7,D0,399,frijol
Yucatán,436,436,2018,7,NPS,0,frijol
Campeche,1560,1544,2018,8,D0,16,frijol
Chiapas,41229,41229,2018,8,D1,0,frijol
Guerrero,456,456,2018,8,D0,0,frijol
Hidalgo,2302,2302,2018,8,D0,0,frijol
Jalisco,1704,1704,2018,8,D0,0,frijol
Nayarit,52691,52691,2018,8,D0,0,frijol
Nuevo León,84,84,2018,8,D0,0,frijol
Oaxaca,3026,3026,2018,8,D0,0,frijol
Puebla,98,98,2018,8,D0,0,frijol
Quintana Roo,1666,1666,2018,8,NPS,0,frijol
San Luis Potosí,984,928,2018,8,D1,56,frijol
Sinaloa,1242,1242,2018,8,D1,0,frijol
Sonora,60,60,2018,8,NPS,0,frijol
Tabasco,2998,2784,2018,8,D2,214,frijol
Tamaulipas,308,259,2018,8,D1,49,frijol
Veracruz de Ignacio de la Llave,19689,19688,2018,8,D1,1,frijol
Yucatán,436,436,2018,8,NPS,0,frijol
Campeche,1560,1544,2018,9,D0,16,frijol
Chiapas,41229,41229,2018,9,D0,0,frijol
Guerrero,456,456,2018,9,D1,0,frijol
Hidalgo,2302,2302,2018,9,D0,0,frijol
Jalisco,1704,1704,2018,9,D0,0,frijol
Nayarit,52691,52691,2018,9,D0,0,frijol
Nuevo León,84,84,2018,9,NPS,0,frijol
Oaxaca,3026,3026,2018,9,D0,0,frijol
Puebla,98,98,2018,9,D0,0,frijol
Quintana Roo,1666,1666,2018,9,D0,0,frijol
San Luis Potosí,984,928,2018,9,NPS,56,frijol
Sinaloa,1242,1242,2018,9,NPS,0,frijol
Sonora,60,60,2018,9,NPS,0,frijol
Tabasco,2998,2784,2018,9,D3,214,frijol
Tamaulipas,308,259,2018,9,NPS,49,frijol
Veracruz de Ignacio de la Llave,19689,19689,2018,9,D1,0,frijol
Yucatán,436,436,2018,9,NPS,0,frijol
Campeche,1560,1544,2018,12,D0,16,frijol
Chiapas,41229,41229,2018,12,D0,0,frijol
Guerrero,456,456,2018,12,NPS,0,frijol
Hidalgo,2302,2302,2018,12,D1,0,frijol
Jalisco,1704,1704,2018,12,NPS,0,frijol
Nayarit,52691,52691,2018,12,NPS,0,frijol
Nuevo León,84,84,2018,12,NPS,0,frijol
Oaxaca,3026,3026,2018,12,NPS,0,frijol
Puebla,98,98,2018,12,NPS,0,frijol
Quintana Roo,1666,1666,2018,12,D1,0,frijol
San Luis Potosí,984,928,2018,12,NPS,56,frijol
Sinaloa,1242,1242,2018,12,NPS,0,frijol
Sonora,60,60,2018,12,NPS,0,frijol
Tabasco,2998,2784,2018,12,D2,214,frijol
Tamaulipas,308,259,2018,12,NPS,49,frijol
Veracruz de Ignacio de la Llave,19689,19689,2018,12,NPS,0,frijol
Yucatán,436,436,2018,12,D0,0,frijol
San Luis Potosí,1029,869,2019,1,D0,160,frijol
Veracruz de Ignacio de la Llave,19326,1866,2019,1,NPS,17460,frijol
Campeche,1492,1438,2019,2,D1,54,frijol
Chiapas,41557,14817,2019,2,D0,26740,frijol
Guerrero,609,341,2019,2,NPS,268,frijol
Hidalgo,1752,1486,2019,2,D1,266,frijol
Nayarit,40471,24711,2019,2,D0,15760,frijol
Oaxaca,3173,63,2019,2,NPS,3110,frijol
Quintana Roo,1686,145,2019,2,NPS,1541,frijol
San Luis Potosí,1029,952,2019,2,D0,77,frijol
Sinaloa,954,850,2019,2,D0,104,frijol
Tamaulipas,268,85,2019,2,D1,183,frijol
Veracruz de Ignacio de la Llave,20539,3171,2019,2,D0,17368,frijol
Campeche,1492,1471,2019,3,D1,21,frijol
Chiapas,41563,35094,2019,3,D1,6469,frijol
Guerrero,702,348,2019,3,D0,354,frijol
Hidalgo,1752,1564,2019,3,D1,188,frijol
Nayarit,40801,35040,2019,3,D0,5761,frijol
Oaxaca,3173,1739,2019,3,NPS,1434,frijol
Quintana Roo,2922,1790,2019,3,NPS,1132,frijol
San Luis Potosí,1029,1029,2019,3,D1,0,frijol
Sinaloa,954,931,2019,3,D1,23,frijol
Tabasco,2906,1258,2019,3,D1,1648,frijol
Tamaulipas,285,270,2019,3,D1,15,frijol
Veracruz de Ignacio de la Llave,21219,6324,2019,3,D0,14895,frijol
Campeche,1492,1471,2019,4,D1,21,frijol
Chiapas,41563,41247,2019,4,D1,316,frijol
Guerrero,702,690,2019,4,D0,12,frijol
Hidalgo,1804,1603,2019,4,D1,201,frijol
Jalisco,1724,757,2019,4,D0,967,frijol
Nayarit,40801,40779,2019,4,D0,22,frijol
Oaxaca,3173,2933,2019,4,NPS,240,frijol
Quintana Roo,2922,2732,2019,4,D0,190,frijol
San Luis Potosí,1029,1029,2019,4,D1,0,frijol
Sinaloa,954,954,2019,4,D1,0,frijol
Sonora,45,20,2019,4,NPS,25,frijol
Tabasco,2906,2584,2019,4,D2,322,frijol
Tamaulipas,285,270,2019,4,D0,15,frijol
Veracruz de Ignacio de la Llave,21219,8978,2019,4,D0,12241,frijol
Yucatán,408,249,2019,4,D0,159,frijol
Campeche,1492,1471,2019,5,D1,21,frijol
Chiapas,41563,41563,2019,5,D1,0,frijol
Guerrero,702,702,2019,5,D1,0,frijol
Hidalgo,1804,1750,2019,5,D1,54,frijol
Jalisco,1724,1599,2019,5,D0,125,frijol
Nayarit,40801,40779,2019,5,D1,22,frijol
Oaxaca,3173,3173,2019,5,D0,0,frijol
Puebla,86,48,2019,5,D0,38,frijol
Quintana Roo,2922,2922,2019,5,D0,0,frijol
San Luis Potosí,1029,1029,2019,5,D1,0,frijol
Sinaloa,954,954,2019,5,D1,0,frijol
Sonora,45,45,2019,5,NPS,0,frijol
Tabasco,2906,2906,2019,5,D3,0,frijol
Tamaulipas,285,270,2019,5,D0,15,frijol
Veracruz de Ignacio de la Llave,21226,15066,2019,5,D0,6160,frijol
Yucatán,408,408,2019,5,D0,0,frijol
Campeche,1492,1471,2019,6,NPS,21,frijol
Chiapas,41563,41563,2019,6,D0,0,frijol
Guerrero,702,702,2019,6,D1,0,frijol
Hidalgo,1804,1804,2019,6,D0,0,frijol
Jalisco,1724,1724,2019,6,D0,0,frijol
Nayarit,40801,40779,2019,6,D1,22,frijol
Oaxaca,3173,3173,2019,6,NPS,0,frijol
Puebla,86,68,2019,6,D0,18,frijol
Quintana Roo,2922,2922,2019,6,D1,0,frijol
San Luis Potosí,1029,1029,2019,6,D1,0,frijol
Sinaloa,954,954,2019,6,D1,0,frijol
Sonora,45,45,2019,6,NPS,0,frijol
Tabasco,2906,2906,2019,6,D3,0,frijol
Tamaulipas,285,270,2019,6,D0,15,frijol
Veracruz de Ignacio de la Llave,21226,19411,2019,6,D0,1815,frijol
Yucatán,408,408,2019,6,NPS,0,frijol
Campeche,1492,1471,2019,7,NPS,21,frijol
Chiapas,41563,41563,2019,7,D0,0,frijol
Guerrero,702,702,2019,7,D1,0,frijol
Hidalgo,1804,1804,2019,7,D0,0,frijol
Jalisco,1724,1724,2019,7,D1,0,frijol
Nayarit,40801,40779,2019,7,D2,22,frijol
Oaxaca,3173,3173,2019,7,D0,0,frijol
Puebla,86,86,2019,7,D0,0,frijol
Quintana Roo,2922,2922,2019,7,D1,0,frijol
San Luis Potosí,1029,1029,2019,7,D2,0,frijol
Sinaloa,954,954,2019,7,D1,0,frijol
Sonora,45,45,2019,7,D0,0,frijol
Tabasco,2906,2906,2019,7,D3,0,frijol
Tamaulipas,285,285,2019,7,D0,0,frijol
Veracruz de Ignacio de la Llave,21226,19854,2019,7,D1,1372,frijol
Yucatán,408,408,2019,7,NPS,0,frijol
Campeche,1492,1471,2019,8,D0,21,frijol
Chiapas,41563,41563,2019,8,D1,0,frijol
Guerrero,702,702,2019,8,D1,0,frijol
Hidalgo,1804,1804,2019,8,D0,0,frijol
Jalisco,1724,1724,2019,8,D0,0,frijol
Nayarit,40801,40779,2019,8,D2,22,frijol
Oaxaca,3173,3173,2019,8,D0,0,frijol
Puebla,86,86,2019,8,NPS,0,frijol
Quintana Roo,2922,2922,2019,8,D1,0,frijol
San Luis Potosí,1029,1029,2019,8,D3,0,frijol
Sinaloa,954,954,2019,8,D1,0,frijol
Sonora,45,45,2019,8,D0,0,frijol
Tabasco,2906,2906,2019,8,D3,0,frijol
Tamaulipas,285,285,2019,8,D0,0,frijol
Veracruz de Ignacio de la Llave,21226,20214,2019,8,D2,1012,frijol
Yucatán,408,408,2019,8,NPS,0,frijol
Campeche,1492,1471,2019,9,D0,21,frijol
Chiapas,41563,41563,2019,9,D1,0,frijol
Guerrero,702,702,2019,9,D1,0,frijol
Hidalgo,1804,1804,2019,9,D0,0,frijol
Jalisco,1724,1724,2019,9,D0,0,frijol
Nayarit,40801,40779,2019,9,D1,22,frijol
Oaxaca,3173,3173,2019,9,D0,0,frijol
Puebla,86,86,2019,9,NPS,0,frijol
Quintana Roo,2922,2922,2019,9,D1,0,frijol
San Luis Potosí,1029,1029,2019,9,D3,0,frijol
Sinaloa,954,954,2019,9,D0,0,frijol
Sonora,45,45,2019,9,D0,0,frijol
Tabasco,2906,2906,2019,9,D3,0,frijol
Tamaulipas,285,285,2019,9,NPS,0,frijol
Veracruz de Ignacio de la Llave,21226,21031,2019,9,D3,195,frijol
Yucatán,408,408,2019,9,D0,0,frijol
Campeche,1492,1471,2019,12,NPS,21,frijol
Chiapas,41563,41563,2019,12,NPS,0,frijol
Guerrero,702,702,2019,12,NPS,0,frijol
Hidalgo,1804,1804,2019,12,D0,0,frijol
Jalisco,1724,1724,2019,12,NPS,0,frijol
Nayarit,40801,40779,2019,12,NPS,22,frijol
Oaxaca,3173,3173,2019,12,NPS,0,frijol
Puebla,86,86,2019,12,NPS,0,frijol
Quintana Roo,2922,2922,2019,12,NPS,0,frijol
San Luis Potosí,1029,1029,2019,12,D1,0,frijol
Sinaloa,954,954,2019,12,NPS,0,frijol
Sonora,45,45,2019,12,NPS,0,frijol
Tabasco,2906,2906,2019,12,D1,0,frijol
Tamaulipas,285,285,2019,12,D1,0,frijol
Veracruz de Ignacio de la Llave,21226,21031,2019,12,D1,195,frijol
Yucatán,408,408,2019,12,NPS,0,frijol
Guerrero,714,221,2020,1,NPS,493,frijol
Nayarit,50075,85,2020,1,NPS,49990,frijol
San Luis Potosí,987,909,2020,1,D3,78,frijol
Sinaloa,1197,30,2020,1,NPS,1167,frijol
Veracruz de Ignacio de la Llave,16543,1883,2020,1,D1,14660,frijol
Campeche,1431,1226,2020,2,D0,205,frijol
Chiapas,41715,13416,2020,2,D0,28299,frijol
Guerrero,714,404,2020,2,NPS,310,frijol
Hidalgo,1703,1627,2020,2,D0,76,frijol
Nayarit,50075,22417,2020,2,NPS,27658,frijol
Oaxaca,3088,72,2020,2,NPS,3016,frijol
Quintana Roo,2477,16,2020,2,D0,2461,frijol
San Luis Potosí,987,966,2020,2,D3,21,frijol
Sinaloa,1245,253,2020,2,NPS,992,frijol
Tamaulipas,158,8,2020,2,D1,150,frijol
Veracruz de Ignacio de la Llave,20166,4661,2020,2,NPS,15505,frijol
Campeche,1431,1299,2020,3,D1,132,frijol
Chiapas,41885,35230,2020,3,D0,6655,frijol
Guerrero,735,460,2020,3,D0,275,frijol
Hidalgo,1876,1703,2020,3,D0,173,frijol
Nayarit,52520,43826,2020,3,NPS,8694,frijol
Oaxaca,3088,72,2020,3,NPS,3016,frijol
Quintana Roo,2552,290,2020,3,D0,2262,frijol
San Luis Potosí,987,987,2020,3,NPS,0,frijol
Sinaloa,1245,1206,2020,3,NPS,39,frijol
Tabasco,2997,1224,2020,3,D1,1773,frijol
Tamaulipas,158,153,2020,3,D1,5,frijol
Veracruz de Ignacio de la Llave,20773,6374,2020,3,D0,14399,frijol
Campeche,1431,1299,2020,4,D1,132,frijol
Chiapas,41885,41304,2020,4,D0,581,frijol
Guerrero,735,714,2020,4,D0,21,frijol
Hidalgo,1876,1703,2020,4,D0,173,frijol
Jalisco,1741,621,2020,4,NPS,1120,frijol
Nayarit,52520,46193,2020,4,NPS,6327,frijol
Oaxaca,3088,2854,2020,4,D0,234,frijol
Quintana Roo,2552,1468,2020,4,D2,1084,frijol
San Luis Potosí,987,987,2020,4,D0,0,frijol
Sinaloa,1245,1206,2020,4,NPS,39,frijol
Sonora,20,10,2020,4,NPS,10,frijol
Tabasco,2997,2573,2020,4,D1,424,frijol
Tamaulipas,158,157,2020,4,D0,1,frijol
Veracruz de Ignacio de la Llave,20773,9750,2020,4,D0,11023,frijol
Yucatán,329,329,2020,4,D2,0,frijol
Campeche,1431,1431,2020,5,NPS,0,frijol
Chiapas,41885,41885,2020,5,NPS,0,frijol
Guerrero,735,735,2020,5,D1,0,frijol
Hidalgo,1876,1703,2020,5,NPS,173,frijol
Jalisco,1741,1579,2020,5,NPS,162,frijol
Nayarit,52520,46193,2020,5,NPS,6327,frijol
Oaxaca,3088,3088,2020,5,NPS,0,frijol
Puebla,59,29,2020,5,NPS,30,frijol
Quintana Roo,2552,1474,2020,5,NPS,1078,frijol
San Luis Potosí,987,987,2020,5,D0,0,frijol
Sinaloa,1245,1238,2020,5,D0,7,frijol
Sonora,20,20,2020,5,NPS,0,frijol
Tabasco,2997,2933,2020,5,NPS,64,frijol
Tamaulipas,158,158,2020,5,D0,0,frijol
Veracruz de Ignacio de la Llave,20773,15290,2020,5,NPS,5483,frijol
Yucatán,329,329,2020,5,NPS,0,frijol
Campeche,1431,1431,2020,6,NPS,0,frijol
Chiapas,41885,41885,2020,6,NPS,0,frijol
Guerrero,735,735,2020,6,D2,0,frijol
Hidalgo,1876,1772,2020,6,D0,104,frijol
Jalisco,1741,1741,2020,6,D0,0,frijol
Nayarit,52520,46193,2020,6,D0,6327,frijol
Oaxaca,3088,3088,2020,6,D0,0,frijol
Puebla,59,41,2020,6,D0,18,frijol
Quintana Roo,2552,2374,2020,6,NPS,178,frijol
San Luis Potosí,987,987,2020,6,D0,0,frijol
Sinaloa,1245,1238,2020,6,D0,7,frijol
Sonora,20,20,2020,6,NPS,0,frijol
Tabasco,2997,2933,2020,6,NPS,64,frijol
Tamaulipas,158,158,2020,6,NPS,0,frijol
Veracruz de Ignacio de la Llave,20773,18925,2020,6,NPS,1848,frijol
Yucatán,329,329,2020,6,NPS,0,frijol
Campeche,1431,1431,2020,7,NPS,0,frijol
Chiapas,41885,41885,2020,7,NPS,0,frijol
Guerrero,735,735,2020,7,D2,0,frijol
Hidalgo,1876,1876,2020,7,D0,0,frijol
Jalisco,1741,1741,2020,7,D0,0,frijol
Nayarit,52520,46193,2020,7,D0,6327,frijol
Oaxaca,3088,3088,2020,7,D0,0,frijol
Puebla,59,41,2020,7,D0,18,frijol
Quintana Roo,2552,2374,2020,7,NPS,178,frijol
San Luis Potosí,987,987,2020,7,D0,0,frijol
Sinaloa,1245,1238,2020,7,D0,7,frijol
Sonora,20,20,2020,7,D0,0,frijol
Tabasco,2997,2933,2020,7,NPS,64,frijol
Tamaulipas,158,158,2020,7,NPS,0,frijol
Veracruz de Ignacio de la Llave,20773,20513,2020,7,NPS,260,frijol
Yucatán,329,329,2020,7,NPS,0,frijol
Campeche,1431,1431,2020,8,NPS,0,frijol
Chiapas,41885,41885,2020,8,NPS,0,frijol
Guerrero,735,735,2020,8,D2,0,frijol
Hidalgo,1876,1876,2020,8,D0,0,frijol
Jalisco,1741,1741,2020,8,D0,0,frijol
Nayarit,52520,46584,2020,8,D0,5936,frijol
Oaxaca,3088,3088,2020,8,NPS,0,frijol
Puebla,59,59,2020,8,NPS,0,frijol
Quintana Roo,2552,2374,2020,8,NPS,178,frijol
San Luis Potosí,987,987,2020,8,D1,0,frijol
Sinaloa,1245,1238,2020,8,D1,7,frijol
Sonora,20,20,2020,8,D0,0,frijol
Tabasco,2997,2933,2020,8,NPS,64,frijol
Tamaulipas,158,158,2020,8,NPS,0,frijol
Veracruz de Ignacio de la Llave,20773,20582,2020,8,NPS,191,frijol
Yucatán,329,329,2020,8,NPS,0,frijol
Campeche,1431,1431,2020,9,D0,0,frijol
Chiapas,41885,41885,2020,9,NPS,0,frijol
Guerrero,735,735,2020,9,D2,0,frijol
Hidalgo,1876,1876,2020,9,D0,0,frijol
Jalisco,1741,1741,2020,9,D0,0,frijol
Nayarit,52520,47936,2020,9,D0,4584,frijol
Oaxaca,3088,3088,2020,9,NPS,0,frijol
Puebla,59,59,2020,9,NPS,0,frijol
Quintana Roo,2552,2374,2020,9,D0,178,frijol
San Luis Potosí,987,987,2020,9,D1,0,frijol
Sinaloa,1245,1238,2020,9,D1,7,frijol
Sonora,20,20,2020,9,D1,0,frijol
Tabasco,2997,2933,2020,9,NPS,64,frijol
Tamaulipas,158,158,2020,9,NPS,0,frijol
Veracruz de Ignacio de la Llave,20773,20773,2020,9,D0,0,frijol
Yucatán,329,329,2020,9,NPS,0,frijol
Campeche,1431,1431,2020,12,NPS,0,frijol
Chiapas,41885,41885,2020,12,NPS,0,frijol
Guerrero,735,735,2020,12,D2,0,frijol
Hidalgo,1876,1876,2020,12,D1,0,frijol
Jalisco,1741,1741,2020,12,D1,0,frijol
Nayarit,52520,47936,2020,12,D1,4584,frijol
Oaxaca,3088,3088,2020,12,NPS,0,frijol
Puebla,59,59,2020,12,NPS,0,frijol
Quintana Roo,2552,2374,2020,12,NPS,178,frijol
San Luis Potosí,987,987,2020,12,D1,0,frijol
Sinaloa,1245,1238,2020,12,D2,7,frijol
Sonora,20,20,2020,12,D3,0,frijol
Tabasco,2997,2933,2020,12,NPS,64,frijol
Tamaulipas,158,158,2020,12,D1,0,frijol
Veracruz de Ignacio de la Llave,20773,20773,2020,12,D0,0,frijol
Yucatán,329,329,2020,12,NPS,0,frijol
Ciudad de México,321,42,2004,8,NPS,279,frijol
Estado de México,18187,2,2004,8,NPS,18185,frijol
Veracruz de Ignacio de la Llave,6531,190,2004,8,D0,6341,frijol
Aguascalientes,11950,2,2004,9,NPS,11948,frijol
Coahuila de Zaragoza,8672,12,2004,9,NPS,8660,frijol
Chiapas,69303,6234,2004,9,D1,63069,frijol
Ciudad de México,321,62,2004,9,NPS,259,frijol
Guanajuato,112827,150,2004,9,NPS,112677,frijol
Jalisco,22010,6,2004,9,NPS,22004,frijol
Estado de México,18225,160,2004,9,NPS,18065,frijol
Oaxaca,36033,160,2004,9,D1,35873,frijol
Puebla,53813,930,2004,9,NPS,52883,frijol
San Luis Potosí,125789,1355,2004,9,NPS,124434,frijol
Tabasco,10,3,2004,9,D1,7,frijol
Veracruz de Ignacio de la Llave,15453,950,2004,9,D0,14503,frijol
Coahuila de Zaragoza,10128,12,2004,9,NPS,10116,frijol
Coahuila de Zaragoza,121,12,2004,9,NPS,109,frijol
Aguascalientes,11950,2746,2004,10,NPS,9204,frijol
Coahuila de Zaragoza,8672,2531,2004,10,NPS,6141,frijol
Chiapas,79818,27347,2004,10,D1,52471,frijol
Chihuahua,69699,19417,2004,10,NPS,50282,frijol
Ciudad de México,321,190,2004,10,NPS,131,frijol
Durango,239019,19088,2004,10,NPS,219931,frijol
Guanajuato,112827,19869,2004,10,NPS,92958,frijol
Guerrero,9491,2448,2004,10,NPS,7043,frijol
Hidalgo,34878,5241,2004,10,NPS,29637,frijol
Jalisco,22099,815,2004,10,NPS,21284,frijol
Estado de México,18175,473,2004,10,NPS,17702,frijol
Michoacán de Ocampo,3200,770,2004,10,NPS,2430,frijol
Morelos,1634,124,2004,10,NPS,1510,frijol
Nuevo León,5045,977,2004,10,NPS,4068,frijol
Oaxaca,36033,861,2004,10,D0,35172,frijol
Puebla,53813,19355,2004,10,NPS,34458,frijol
Querétaro de Arteaga,18208,2768,2004,10,NPS,15440,frijol
San Luis Potosí,125789,50056,2004,10,NPS,75733,frijol
Sonora,1152,33,2004,10,NPS,1119,frijol
Tabasco,10,10,2004,10,D1,0,frijol
Tamaulipas,5244,144,2004,10,NPS,5100,frijol
Tlaxcala,7051,4965,2004,10,NPS,2086,frijol
Veracruz de Ignacio de la Llave,15453,1125,2004,10,D0,14328,frijol
Zacatecas,590370,125480,2004,10,NPS,464890,frijol
Coahuila de Zaragoza,10132,584,2004,10,NPS,9548,frijol
Coahuila de Zaragoza,121,116,2004,10,NPS,5,frijol
Durango,10011,468,2004,10,NPS,9543,frijol
Aguascalientes,11950,10570,2004,11,NPS,1380,frijol
Baja California,428,2,2004,11,D0,426,frijol
Coahuila de Zaragoza,8672,5936,2004,11,NPS,2736,frijol
Chiapas,83058,37272,2004,11,D1,45786,frijol
Chihuahua,69769,36771,2004,11,NPS,32998,frijol
Ciudad de México,321,190,2004,11,NPS,131,frijol
Durango,239019,185284,2004,11,NPS,53735,frijol
Guanajuato,112827,75673,2004,11,NPS,37154,frijol
Guerrero,9491,7151,2004,11,NPS,2340,frijol
Hidalgo,34878,25888,2004,11,NPS,8990,frijol
Jalisco,22098,1610,2004,11,NPS,20488,frijol
Estado de México,18175,14370,2004,11,NPS,3805,frijol
Michoacán de Ocampo,3176,1829,2004,11,NPS,1347,frijol
Morelos,1634,163,2004,11,NPS,1471,frijol
Nayarit,161,83,2004,11,NPS,78,frijol
Nuevo León,4865,3617,2004,11,NPS,1248,frijol
Oaxaca,36033,8204,2004,11,D0,27829,frijol
Puebla,53813,37052,2004,11,NPS,16761,frijol
Querétaro de Arteaga,18208,10060,2004,11,NPS,8148,frijol
San Luis Potosí,125789,105503,2004,11,NPS,20286,frijol
Sinaloa,2178,976,2004,11,NPS,1202,frijol
Sonora,1152,33,2004,11,NPS,1119,frijol
Tabasco,10,10,2004,11,D1,0,frijol
Tamaulipas,5522,229,2004,11,NPS,5293,frijol
Tlaxcala,7051,6702,2004,11,NPS,349,frijol
Veracruz de Ignacio de la Llave,15453,1695,2004,11,D0,13758,frijol
Zacatecas,590370,480612,2004,11,NPS,109758,frijol
Coahuila de Zaragoza,10132,9193,2004,11,NPS,939,frijol
Coahuila de Zaragoza,121,118,2004,11,NPS,3,frijol
Durango,10011,9075,2004,11,NPS,936,frijol
Aguascalientes,11950,10570,2005,1,NPS,1380,frijol
Baja California,428,2,2005,1,NPS,426,frijol
Coahuila de Zaragoza,8672,8309,2005,1,NPS,363,frijol
Chiapas,88578,70531,2005,1,D1,18047,frijol
Chihuahua,69769,37220,2005,1,NPS,32549,frijol
Ciudad de México,321,321,2005,1,NPS,0,frijol
Durango,238083,236132,2005,1,NPS,1951,frijol
Guanajuato,112827,97182,2005,1,NPS,15645,frijol
Guerrero,9491,8885,2005,1,NPS,606,frijol
Hidalgo,34878,31259,2005,1,D0,3619,frijol
Jalisco,22104,20461,2005,1,NPS,1643,frijol
Estado de México,18175,17917,2005,1,NPS,258,frijol
Michoacán de Ocampo,3176,3065,2005,1,NPS,111,frijol
Morelos,1634,1634,2005,1,NPS,0,frijol
Nayarit,161,161,2005,1,D0,0,frijol
Nuevo León,4865,4664,2005,1,NPS,201,frijol
Oaxaca,36033,31804,2005,1,D0,4229,frijol
Puebla,53813,43063,2005,1,NPS,10750,frijol
Querétaro de Arteaga,18208,13282,2005,1,NPS,4926,frijol
San Luis Potosí,125789,117858,2005,1,NPS,7931,frijol
Sinaloa,2178,976,2005,1,NPS,1202,frijol
Sonora,1152,33,2005,1,NPS,1119,frijol
Tabasco,10,10,2005,1,D1,0,frijol
Tamaulipas,5522,3878,2005,1,D0,1644,frijol
Tlaxcala,7051,7005,2005,1,NPS,46,frijol
Veracruz de Ignacio de la Llave,15453,7707,2005,1,D1,7746,frijol
Zacatecas,590370,547378,2005,1,NPS,42992,frijol
Coahuila de Zaragoza,10132,9749,2005,1,NPS,383,frijol
Coahuila de Zaragoza,121,118,2005,1,NPS,3,frijol
Durango,10011,9631,2005,1,NPS,380,frijol
Aguascalientes,11950,10570,2005,2,NPS,1380,frijol
Baja California,428,2,2005,2,NPS,426,frijol
Coahuila de Zaragoza,8672,8309,2005,2,NPS,363,frijol
Chiapas,88578,81250,2005,2,D1,7328,frijol
Chihuahua,69769,37220,2005,2,NPS,32549,frijol
Ciudad de México,321,321,2005,2,NPS,0,frijol
Durango,238083,236159,2005,2,NPS,1924,frijol
Guanajuato,112827,97182,2005,2,NPS,15645,frijol
Guerrero,9491,9486,2005,2,NPS,5,frijol
Hidalgo,34878,31259,2005,2,NPS,3619,frijol
Jalisco,22104,21414,2005,2,NPS,690,frijol
Estado de México,18175,18017,2005,2,NPS,158,frijol
Michoacán de Ocampo,3176,3088,2005,2,NPS,88,frijol
Morelos,1634,1634,2005,2,NPS,0,frijol
Nayarit,161,161,2005,2,NPS,0,frijol
Nuevo León,4778,4770,2005,2,NPS,8,frijol
Oaxaca,36033,32599,2005,2,D0,3434,frijol
Puebla,53813,43353,2005,2,NPS,10460,frijol
Querétaro de Arteaga,18208,13282,2005,2,NPS,4926,frijol
San Luis Potosí,125789,117858,2005,2,NPS,7931,frijol
Sinaloa,2178,976,2005,2,NPS,1202,frijol
Sonora,1152,87,2005,2,NPS,1065,frijol
Tabasco,10,10,2005,2,D2,0,frijol
Tamaulipas,5522,4090,2005,2,NPS,1432,frijol
Tlaxcala,7051,7005,2005,2,NPS,46,frijol
Veracruz de Ignacio de la Llave,15456,13262,2005,2,D1,2194,frijol
Zacatecas,590370,547378,2005,2,NPS,42992,frijol
Coahuila de Zaragoza,10132,9749,2005,2,NPS,383,frijol
Coahuila de Zaragoza,121,118,2005,2,NPS,3,frijol
Durango,10011,9631,2005,2,NPS,380,frijol
Baja California,966,836,2005,8,NPS,130,frijol
Chiapas,65692,8240,2005,8,NPS,57452,frijol
Tabasco,30,10,2005,8,NPS,20,frijol
Veracruz de Ignacio de la Llave,6353,200,2005,8,NPS,6153,frijol
Baja California,966,836,2005,9,NPS,130,frijol
Chiapas,71212,17251,2005,9,NPS,53961,frijol
Oaxaca,40122,15,2005,9,NPS,40107,frijol
Puebla,58243,500,2005,9,D0,57743,frijol
Tabasco,30,10,2005,9,NPS,20,frijol
Veracruz de Ignacio de la Llave,9844,3614,2005,9,NPS,6230,frijol
Aguascalientes,10819,653,2005,10,NPS,10166,frijol
Baja California,866,866,2005,10,NPS,0,frijol
Coahuila de Zaragoza,5490,1074,2005,10,NPS,4416,frijol
Chiapas,81398,19328,2005,10,NPS,62070,frijol
Chihuahua,54925,4144,2005,10,NPS,50781,frijol
Ciudad de México,319,60,2005,10,NPS,259,frijol
Durango,247615,55,2005,10,NPS,247560,frijol
Guanajuato,84655,478,2005,10,NPS,84177,frijol
Guerrero,10587,1860,2005,10,NPS,8727,frijol
Hidalgo,28099,1246,2005,10,NPS,26853,frijol
Estado de México,12202,526,2005,10,D0,11676,frijol
Michoacán de Ocampo,2791,273,2005,10,D0,2518,frijol
Morelos,1857,182,2005,10,D0,1675,frijol
Oaxaca,40122,15,2005,10,NPS,40107,frijol
Puebla,58243,4637,2005,10,NPS,53606,frijol
San Luis Potosí,103702,39118,2005,10,NPS,64584,frijol
Sonora,95,77,2005,10,D0,18,frijol
Tabasco,30,10,2005,10,D0,20,frijol
Tlaxcala,6794,3735,2005,10,NPS,3059,frijol
Veracruz de Ignacio de la Llave,11095,4041,2005,10,NPS,7054,frijol
Zacatecas,582604,848,2005,10,NPS,581756,frijol
Coahuila de Zaragoza,9068,25,2005,10,NPS,9043,frijol
Coahuila de Zaragoza,53,25,2005,10,NPS,28,frijol
Aguascalientes,10819,1410,2005,11,NPS,9409,frijol
Baja California,866,866,2005,11,NPS,0,frijol
Coahuila de Zaragoza,5490,2960,2005,11,NPS,2530,frijol
Colima,6,6,2005,11,D0,0,frijol
Chiapas,81398,40222,2005,11,NPS,41176,frijol
Chihuahua,54925,26835,2005,11,NPS,28090,frijol
Ciudad de México,319,189,2005,11,D0,130,frijol
Durango,247615,156371,2005,11,NPS,91244,frijol
Guanajuato,84655,17234,2005,11,NPS,67421,frijol
Guerrero,10587,6444,2005,11,NPS,4143,frijol
Hidalgo,27904,15082,2005,11,NPS,12822,frijol
Jalisco,16238,1207,2005,11,D0,15031,frijol
Estado de México,12202,5827,2005,11,D0,6375,frijol
Michoacán de Ocampo,3176,1478,2005,11,D0,1698,frijol
Morelos,1857,358,2005,11,D0,1499,frijol
Nuevo León,2658,642,2005,11,NPS,2016,frijol
Oaxaca,40122,5104,2005,11,NPS,35018,frijol
Puebla,58243,41357,2005,11,NPS,16886,frijol
Querétaro de Arteaga,16467,2358,2005,11,NPS,14109,frijol
San Luis Potosí,103702,76036,2005,11,NPS,27666,frijol
Sonora,1295,95,2005,11,D0,1200,frijol
Tabasco,30,10,2005,11,D0,20,frijol
Tamaulipas,2859,350,2005,11,NPS,2509,frijol
Tlaxcala,6794,5993,2005,11,D0,801,frijol
Veracruz de Ignacio de la Llave,9340,5340,2005,11,NPS,4000,frijol
Yucatán,63,1,2005,11,NPS,62,frijol
Zacatecas,582604,227081,2005,11,NPS,355523,frijol
Coahuila de Zaragoza,9068,25,2005,11,NPS,9043,frijol
Coahuila de Zaragoza,53,25,2005,11,NPS,28,frijol
Aguascalientes,10819,6602,2006,1,D0,4217,frijol
Baja California,866,866,2006,1,D0,0,frijol
Coahuila de Zaragoza,5490,3578,2006,1,D0,1912,frijol
Colima,6,6,2006,1,D1,0,frijol
Chiapas,81398,68350,2006,1,NPS,13048,frijol
Chihuahua,54925,28833,2006,1,D1,26092,frijol
Ciudad de México,319,319,2006,1,D0,0,frijol
Durango,247615,179651,2006,1,D0,67964,frijol
Guanajuato,84655,31941,2006,1,D0,52714,frijol
Guerrero,10587,9913,2006,1,D0,674,frijol
Hidalgo,27904,25432,2006,1,D0,2472,frijol
Jalisco,16238,14258,2006,1,D1,1980,frijol
Estado de México,12202,11150,2006,1,D0,1052,frijol
Michoacán de Ocampo,3176,2511,2006,1,D1,665,frijol
Morelos,1857,1466,2006,1,D0,391,frijol
Nayarit,307,44,2006,1,D1,263,frijol
Nuevo León,2509,2196,2006,1,D0,313,frijol
Oaxaca,40307,36917,2006,1,D0,3390,frijol
Puebla,58243,50632,2006,1,D0,7611,frijol
Querétaro de Arteaga,16467,7106,2006,1,D0,9361,frijol
San Luis Potosí,103702,82976,2006,1,D0,20726,frijol
Sinaloa,1460,199,2006,1,D1,1261,frijol
Sonora,1377,95,2006,1,D1,1282,frijol
Tabasco,30,10,2006,1,NPS,20,frijol
Tamaulipas,2859,2570,2006,1,D0,289,frijol
Tlaxcala,6815,6815,2006,1,D0,0,frijol
Veracruz de Ignacio de la Llave,9425,7817,2006,1,NPS,1608,frijol
Yucatán,63,24,2006,1,NPS,39,frijol
Zacatecas,582604,320592,2006,1,D0,262012,frijol
Coahuila de Zaragoza,9068,5787,2006,1,D0,3281,frijol
Coahuila de Zaragoza,53,37,2006,1,D0,16,frijol
Durango,9015,5750,2006,1,D0,3265,frijol
Aguascalientes,10819,6602,2006,2,D1,4217,frijol
Baja California,866,866,2006,2,D0,0,frijol
Coahuila de Zaragoza,5490,3578,2006,2,D0,1912,frijol
Colima,6,6,2006,2,D1,0,frijol
Chiapas,81398,74447,2006,2,NPS,6951,frijol
Chihuahua,54925,28833,2006,2,D2,26092,frijol
Ciudad de México,319,319,2006,2,D1,0,frijol
Durango,247615,179652,2006,2,D1,67963,frijol
Guanajuato,84655,31941,2006,2,D1,52714,frijol
Guerrero,10587,9913,2006,2,D0,674,frijol
Hidalgo,27904,25432,2006,2,D0,2472,frijol
Jalisco,16240,14503,2006,2,D1,1737,frijol
Estado de México,12202,11150,2006,2,D1,1052,frijol
Michoacán de Ocampo,3176,2602,2006,2,D1,574,frijol
Morelos,1857,1579,2006,2,D1,278,frijol
Nayarit,307,300,2006,2,D1,7,frijol
Nuevo León,2509,2204,2006,2,D0,305,frijol
Oaxaca,40307,36917,2006,2,D0,3390,frijol
Puebla,58243,51282,2006,2,D0,6961,frijol
Querétaro de Arteaga,16467,7706,2006,2,D1,8761,frijol
San Luis Potosí,103702,83402,2006,2,D0,20300,frijol
Sinaloa,1460,199,2006,2,D3,1261,frijol
Sonora,1377,95,2006,2,D2,1282,frijol
Tabasco,30,10,2006,2,NPS,20,frijol
Tamaulipas,2859,2645,2006,2,D0,214,frijol
Tlaxcala,6837,6837,2006,2,D1,0,frijol
Veracruz de Ignacio de la Llave,9473,8514,2006,2,NPS,959,frijol
Yucatán,63,24,2006,2,NPS,39,frijol
Zacatecas,582604,320592,2006,2,D1,262012,frijol
Coahuila de Zaragoza,9068,5787,2006,2,D0,3281,frijol
Coahuila de Zaragoza,53,37,2006,2,D0,16,frijol
Durango,9015,5750,2006,2,D1,3265,frijol
Baja California,449,24,2006,8,D0,425,frijol
Chiapas,66340,7151,2006,8,NPS,59189,frijol
Oaxaca,34639,173,2006,8,NPS,34466,frijol
Puebla,57315,900,2006,8,D0,56415,frijol
Tamaulipas,116,7,2006,8,D0,109,frijol
Tlaxcala,6832,41,2006,8,D0,6791,frijol
Veracruz de Ignacio de la Llave,12764,100,2006,8,D1,12664,frijol
Zacatecas,559914,1995,2006,8,NPS,557919,frijol
Baja California,449,24,2006,9,D0,425,frijol
Coahuila de Zaragoza,6834,110,2006,9,NPS,6724,frijol
Chiapas,78249,20542,2006,9,D0,57707,frijol
Chihuahua,78748,2,2006,9,NPS,78746,frijol
Ciudad de México,317,42,2006,9,NPS,275,frijol
Guanajuato,90152,137,2006,9,NPS,90015,frijol
Guerrero,10604,147,2006,9,NPS,10457,frijol
Hidalgo,30678,400,2006,9,NPS,30278,frijol
Estado de México,14057,180,2006,9,NPS,13877,frijol
Oaxaca,37280,173,2006,9,NPS,37107,frijol
Puebla,57620,2413,2006,9,NPS,55207,frijol
Tabasco,14,10,2006,9,D0,4,frijol
Tamaulipas,2172,7,2006,9,D0,2165,frijol
Tlaxcala,6832,589,2006,9,NPS,6243,frijol
Veracruz de Ignacio de la Llave,13633,731,2006,9,NPS,12902,frijol
Zacatecas,577618,3198,2006,9,NPS,574420,frijol
Coahuila de Zaragoza,10419,110,2006,9,NPS,10309,frijol
Coahuila de Zaragoza,127,110,2006,9,NPS,17,frijol
Aguascalientes,9707,227,2006,10,NPS,9480,frijol
Baja California,449,24,2006,10,D1,425,frijol
Coahuila de Zaragoza,6838,695,2006,10,D2,6143,frijol
Colima,13,5,2006,10,NPS,8,frijol
Chiapas,81979,36701,2006,10,NPS,45278,frijol
Chihuahua,79272,43809,2006,10,NPS,35463,frijol
Ciudad de México,317,67,2006,10,NPS,250,frijol
Durango,242448,39716,2006,10,NPS,202732,frijol
Guanajuato,90152,9455,2006,10,NPS,80697,frijol
Guerrero,10604,1648,2006,10,NPS,8956,frijol
Hidalgo,30678,4698,2006,10,NPS,25980,frijol
Jalisco,15687,2073,2006,10,NPS,13614,frijol
Estado de México,14077,3766,2006,10,NPS,10311,frijol
Michoacán de Ocampo,2980,194,2006,10,NPS,2786,frijol
Morelos,1848,166,2006,10,NPS,1682,frijol
Nuevo León,2276,350,2006,10,NPS,1926,frijol
Oaxaca,37279,8293,2006,10,NPS,28986,frijol
Puebla,57620,21690,2006,10,NPS,35930,frijol
Querétaro de Arteaga,15097,8,2006,10,D1,15089,frijol
Quintana Roo,16,4,2006,10,D1,12,frijol
San Luis Potosí,102006,50490,2006,10,NPS,51516,frijol
Tabasco,14,14,2006,10,D0,0,frijol
Tamaulipas,3009,7,2006,10,NPS,3002,frijol
Tlaxcala,6832,3891,2006,10,NPS,2941,frijol
Veracruz de Ignacio de la Llave,13633,3288,2006,10,D0,10345,frijol
Yucatán,1,1,2006,10,D0,0,frijol
Zacatecas,578500,82382,2006,10,NPS,496118,frijol
Coahuila de Zaragoza,10685,302,2006,10,D2,10383,frijol
Coahuila de Zaragoza,127,110,2006,10,D2,17,frijol
Durango,10558,192,2006,10,NPS,10366,frijol
Aguascalientes,9707,7616,2006,11,NPS,2091,frijol
Baja California,449,24,2006,11,D2,425,frijol
Coahuila de Zaragoza,6838,4253,2006,11,D0,2585,frijol
Colima,13,8,2006,11,NPS,5,frijol
Chiapas,81979,47774,2006,11,D0,34205,frijol
Chihuahua,79281,72203,2006,11,NPS,7078,frijol
Ciudad de México,317,75,2006,11,NPS,242,frijol
Durango,242448,219158,2006,11,NPS,23290,frijol
Guanajuato,90152,46273,2006,11,NPS,43879,frijol
Guerrero,10604,4644,2006,11,NPS,5960,frijol
Hidalgo,30678,27898,2006,11,D1,2780,frijol
Jalisco,15687,7799,2006,11,NPS,7888,frijol
Estado de México,14072,7008,2006,11,NPS,7064,frijol
Michoacán de Ocampo,2980,822,2006,11,NPS,2158,frijol
Morelos,1848,550,2006,11,NPS,1298,frijol
Nayarit,364,340,2006,11,NPS,24,frijol
Nuevo León,2276,690,2006,11,NPS,1586,frijol
Oaxaca,37280,16485,2006,11,NPS,20795,frijol
Puebla,57620,42118,2006,11,NPS,15502,frijol
Querétaro de Arteaga,15097,2713,2006,11,NPS,12384,frijol
Quintana Roo,16,8,2006,11,NPS,8,frijol
San Luis Potosí,102006,79223,2006,11,NPS,22783,frijol
Sinaloa,775,168,2006,11,NPS,607,frijol
Sonora,944,510,2006,11,NPS,434,frijol
Tabasco,14,14,2006,11,NPS,0,frijol
Tamaulipas,3019,50,2006,11,NPS,2969,frijol
Tlaxcala,6832,6658,2006,11,D1,174,frijol
Veracruz de Ignacio de la Llave,13753,6004,2006,11,NPS,7749,frijol
Yucatán,1,1,2006,11,D0,0,frijol
Zacatecas,578500,425517,2006,11,NPS,152983,frijol
Coahuila de Zaragoza,10685,1076,2006,11,D0,9609,frijol
Coahuila de Zaragoza,127,120,2006,11,D0,7,frijol
Durango,10558,956,2006,11,NPS,9602,frijol
Aguascalientes,9707,9044,2007,1,NPS,663,frijol
Baja California,449,24,2007,1,D2,425,frijol
Coahuila de Zaragoza,6838,4270,2007,1,NPS,2568,frijol
Colima,13,13,2007,1,D1,0,frijol
Chiapas,81979,73724,2007,1,NPS,8255,frijol
Chihuahua,79281,74626,2007,1,NPS,4655,frijol
Ciudad de México,317,317,2007,1,NPS,0,frijol
Durango,242448,241760,2007,1,NPS,688,frijol
Guanajuato,90152,70746,2007,1,NPS,19406,frijol
Guerrero,10756,7126,2007,1,NPS,3630,frijol
Hidalgo,30678,29093,2007,1,D1,1585,frijol
Jalisco,15707,9722,2007,1,NPS,5985,frijol
Estado de México,14074,14043,2007,1,NPS,31,frijol
Michoacán de Ocampo,2979,2838,2007,1,NPS,141,frijol
Morelos,1852,1614,2007,1,NPS,238,frijol
Nayarit,364,350,2007,1,D1,14,frijol
Nuevo León,2276,1380,2007,1,NPS,896,frijol
Oaxaca,37280,31863,2007,1,NPS,5417,frijol
Puebla,57690,54017,2007,1,NPS,3673,frijol
Querétaro de Arteaga,15097,6324,2007,1,NPS,8773,frijol
Quintana Roo,16,12,2007,1,D0,4,frijol
San Luis Potosí,102006,87980,2007,1,NPS,14026,frijol
Sinaloa,775,684,2007,1,D1,91,frijol
Sonora,944,510,2007,1,NPS,434,frijol
Tabasco,14,14,2007,1,NPS,0,frijol
Tamaulipas,3019,1685,2007,1,NPS,1334,frijol
Tlaxcala,6832,6818,2007,1,NPS,14,frijol
Veracruz de Ignacio de la Llave,13753,10822,2007,1,NPS,2931,frijol
Yucatán,1,1,2007,1,NPS,0,frijol
Zacatecas,578500,569100,2007,1,NPS,9400,frijol
Coahuila de Zaragoza,10685,10382,2007,1,NPS,303,frijol
Coahuila de Zaragoza,127,120,2007,1,NPS,7,frijol
Durango,10558,10262,2007,1,NPS,296,frijol
Aguascalientes,9707,9044,2007,2,NPS,663,frijol
Baja California,449,24,2007,2,D1,425,frijol
Coahuila de Zaragoza,6838,4270,2007,2,D0,2568,frijol
Colima,13,13,2007,2,NPS,0,frijol
Chiapas,81979,81979,2007,2,NPS,0,frijol
Chihuahua,79281,74626,2007,2,NPS,4655,frijol
Ciudad de México,317,317,2007,2,NPS,0,frijol
Durango,242448,241760,2007,2,NPS,688,frijol
Guanajuato,90152,70746,2007,2,NPS,19406,frijol
Guerrero,10756,10756,2007,2,NPS,0,frijol
Hidalgo,30678,29093,2007,2,NPS,1585,frijol
Jalisco,15707,9844,2007,2,NPS,5863,frijol
Estado de México,14074,14073,2007,2,NPS,1,frijol
Michoacán de Ocampo,2979,2908,2007,2,NPS,71,frijol
Morelos,1852,1840,2007,2,NPS,12,frijol
Nayarit,364,364,2007,2,D1,0,frijol
Nuevo León,2276,1432,2007,2,NPS,844,frijol
Oaxaca,37280,31863,2007,2,NPS,5417,frijol
Puebla,57690,54167,2007,2,NPS,3523,frijol
Querétaro de Arteaga,15097,7207,2007,2,NPS,7890,frijol
Quintana Roo,16,14,2007,2,D1,2,frijol
San Luis Potosí,102006,87980,2007,2,NPS,14026,frijol
Sinaloa,775,684,2007,2,D0,91,frijol
Sonora,944,510,2007,2,NPS,434,frijol
Tabasco,14,14,2007,2,NPS,0,frijol
Tamaulipas,3019,2996,2007,2,NPS,23,frijol
Tlaxcala,6813,6799,2007,2,D1,14,frijol
Veracruz de Ignacio de la Llave,14044,13894,2007,2,NPS,150,frijol
Yucatán,1,1,2007,2,NPS,0,frijol
Zacatecas,578500,569100,2007,2,NPS,9400,frijol
Coahuila de Zaragoza,10685,10382,2007,2,D0,303,frijol
Coahuila de Zaragoza,127,120,2007,2,D0,7,frijol
Durango,10558,10262,2007,2,NPS,296,frijol
Ciudad de México,288,16,2007,7,D0,272,frijol
Chiapas,67847,4233,2007,8,NPS,63614,frijol
Ciudad de México,288,35,2007,8,NPS,253,frijol
Puebla,62740,800,2007,8,NPS,61940,frijol
Quintana Roo,18,2,2007,8,NPS,16,frijol
Tlaxcala,6658,93,2007,8,NPS,6565,frijol
Chiapas,76134,18319,2007,9,D0,57815,frijol
Ciudad de México,288,56,2007,9,NPS,232,frijol
Durango,221934,255,2007,9,D0,221679,frijol
Guanajuato,92284,140,2007,9,NPS,92144,frijol
Guerrero,9863,302,2007,9,NPS,9561,frijol
Estado de México,13858,27,2007,9,NPS,13831,frijol
Michoacán de Ocampo,2756,80,2007,9,D0,2676,frijol
Morelos,1999,2,2007,9,NPS,1997,frijol
Nuevo León,4145,100,2007,9,NPS,4045,frijol
Oaxaca,36666,149,2007,9,NPS,36517,frijol
Puebla,62710,3588,2007,9,NPS,59122,frijol
Quintana Roo,18,2,2007,9,D1,16,frijol
Tlaxcala,6658,93,2007,9,NPS,6565,frijol
Veracruz de Ignacio de la Llave,11649,220,2007,9,NPS,11429,frijol
Coahuila de Zaragoza,9386,255,2007,9,NPS,9131,frijol
Durango,9360,255,2007,9,D0,9105,frijol
Aguascalientes,9898,1069,2007,10,NPS,8829,frijol
Coahuila de Zaragoza,6678,1102,2007,10,NPS,5576,frijol
Chiapas,83663,42874,2007,10,NPS,40789,frijol
Chihuahua,67803,31572,2007,10,D1,36231,frijol
Ciudad de México,288,77,2007,10,NPS,211,frijol
Durango,221934,1470,2007,10,D1,220464,frijol
Guanajuato,92326,4143,2007,10,NPS,88183,frijol
Guerrero,9950,1601,2007,10,NPS,8349,frijol
Hidalgo,33007,5867,2007,10,NPS,27140,frijol
Jalisco,12790,4933,2007,10,D0,7857,frijol
Estado de México,13858,595,2007,10,NPS,13263,frijol
Michoacán de Ocampo,2756,670,2007,10,NPS,2086,frijol
Morelos,1999,211,2007,10,NPS,1788,frijol
Nuevo León,4279,455,2007,10,NPS,3824,frijol
Oaxaca,36666,2449,2007,10,NPS,34217,frijol
Puebla,62721,22710,2007,10,NPS,40011,frijol
Querétaro de Arteaga,15045,126,2007,10,NPS,14919,frijol
Quintana Roo,18,2,2007,10,D1,16,frijol
San Luis Potosí,116424,67979,2007,10,NPS,48445,frijol
Sinaloa,727,286,2007,10,NPS,441,frijol
Sonora,2121,67,2007,10,NPS,2054,frijol
Tabasco,7,7,2007,10,NPS,0,frijol
Tamaulipas,3337,8,2007,10,NPS,3329,frijol
Tlaxcala,6640,4466,2007,10,NPS,2174,frijol
Veracruz de Ignacio de la Llave,11769,2496,2007,10,NPS,9273,frijol
Yucatán,3,3,2007,10,NPS,0,frijol
Zacatecas,537982,118358,2007,10,NPS,419624,frijol
Coahuila de Zaragoza,9386,265,2007,10,NPS,9121,frijol
Durango,9360,265,2007,10,D1,9095,frijol
Aguascalientes,9898,2172,2007,11,NPS,7726,frijol
Coahuila de Zaragoza,6678,5498,2007,11,D0,1180,frijol
Colima,13,13,2007,11,NPS,0,frijol
Chiapas,83663,48573,2007,11,NPS,35090,frijol
Chihuahua,67803,57672,2007,11,D0,10131,frijol
Ciudad de México,288,135,2007,11,NPS,153,frijol
Durango,221934,200960,2007,11,D0,20974,frijol
Guanajuato,92326,32985,2007,11,NPS,59341,frijol
Guerrero,9886,7326,2007,11,NPS,2560,frijol
Hidalgo,33007,28741,2007,11,NPS,4266,frijol
Jalisco,12790,8354,2007,11,D2,4436,frijol
Estado de México,13858,9966,2007,11,NPS,3892,frijol
Michoacán de Ocampo,2756,1168,2007,11,NPS,1588,frijol
Morelos,1999,211,2007,11,NPS,1788,frijol
Nayarit,432,364,2007,11,D2,68,frijol
Nuevo León,4279,3422,2007,11,D0,857,frijol
Oaxaca,36962,13054,2007,11,NPS,23908,frijol
Puebla,62728,55844,2007,11,NPS,6884,frijol
Querétaro de Arteaga,15045,5675,2007,11,NPS,9370,frijol
Quintana Roo,18,2,2007,11,D2,16,frijol
San Luis Potosí,116474,92654,2007,11,NPS,23820,frijol
Sinaloa,727,286,2007,11,D0,441,frijol
Sonora,2171,67,2007,11,NPS,2104,frijol
Tabasco,7,7,2007,11,NPS,0,frijol
Tamaulipas,3337,361,2007,11,D0,2976,frijol
Tlaxcala,6616,6115,2007,11,NPS,501,frijol
Veracruz de Ignacio de la Llave,11769,3237,2007,11,NPS,8532,frijol
Yucatán,3,3,2007,11,NPS,0,frijol
Zacatecas,537982,358586,2007,11,NPS,179396,frijol
Coahuila de Zaragoza,9386,7200,2007,11,D0,2186,frijol
Coahuila de Zaragoza,26,19,2007,11,D0,7,frijol
Durango,9360,7181,2007,11,D0,2179,frijol
Aguascalientes,9898,2859,2008,1,D0,7039,frijol
Campeche,40,40,2008,1,D1,0,frijol
Coahuila de Zaragoza,6678,5657,2008,1,D0,1021,frijol
Colima,13,13,2008,1,D0,0,frijol
Chiapas,83663,78376,2008,1,NPS,5287,frijol
Chihuahua,68069,63829,2008,1,D0,4240,frijol
Ciudad de México,288,288,2008,1,NPS,0,frijol
Durango,221934,201184,2008,1,D1,20750,frijol
Guanajuato,92326,66242,2008,1,D1,26084,frijol
Guerrero,9886,9615,2008,1,NPS,271,frijol
Hidalgo,33007,29493,2008,1,NPS,3514,frijol
Jalisco,12790,9140,2008,1,D2,3650,frijol
Estado de México,13858,13031,2008,1,NPS,827,frijol
Michoacán de Ocampo,2756,2514,2008,1,D1,242,frijol
Morelos,1999,1938,2008,1,NPS,61,frijol
Nayarit,432,432,2008,1,D2,0,frijol
Nuevo León,4279,4084,2008,1,NPS,195,frijol
Oaxaca,36962,30201,2008,1,NPS,6761,frijol
Puebla,62728,59291,2008,1,NPS,3437,frijol
Querétaro de Arteaga,15045,11092,2008,1,NPS,3953,frijol
Quintana Roo,18,2,2008,1,D2,16,frijol
San Luis Potosí,116478,99713,2008,1,NPS,16765,frijol
Sinaloa,727,568,2008,1,D1,159,frijol
Sonora,2171,1067,2008,1,NPS,1104,frijol
Tabasco,7,7,2008,1,NPS,0,frijol
Tamaulipas,3337,2043,2008,1,D0,1294,frijol
Tlaxcala,6652,6612,2008,1,NPS,40,frijol
Veracruz de Ignacio de la Llave,11769,8133,2008,1,NPS,3636,frijol
Yucatán,3,3,2008,1,D2,0,frijol
Zacatecas,537982,437358,2008,1,NPS,100624,frijol
Coahuila de Zaragoza,9386,7278,2008,1,D0,2108,frijol
Coahuila de Zaragoza,26,19,2008,1,D0,7,frijol
Durango,9360,7259,2008,1,D1,2101,frijol
Aguascalientes,9898,2859,2008,2,NPS,7039,frijol
Campeche,40,40,2008,2,D0,0,frijol
Coahuila de Zaragoza,6678,5657,2008,2,D1,1021,frijol
Colima,13,13,2008,2,D0,0,frijol
Chiapas,83663,82189,2008,2,NPS,1474,frijol
Chihuahua,68069,63829,2008,2,D0,4240,frijol
Ciudad de México,288,288,2008,2,NPS,0,frijol
Durango,221934,201184,2008,2,D1,20750,frijol
Guanajuato,92326,66242,2008,2,D1,26084,frijol
Guerrero,9704,9615,2008,2,D0,89,frijol
Hidalgo,33007,29493,2008,2,NPS,3514,frijol
Jalisco,12790,9209,2008,2,D2,3581,frijol
Estado de México,13858,13681,2008,2,NPS,177,frijol
Michoacán de Ocampo,2756,2703,2008,2,D2,53,frijol
Morelos,1999,1994,2008,2,D0,5,frijol
Nayarit,432,432,2008,2,D2,0,frijol
Nuevo León,4279,4084,2008,2,D0,195,frijol
Oaxaca,36962,35462,2008,2,NPS,1500,frijol
Puebla,62728,61451,2008,2,NPS,1277,frijol
Querétaro de Arteaga,15045,11092,2008,2,NPS,3953,frijol
Quintana Roo,18,2,2008,2,D2,16,frijol
San Luis Potosí,116478,99713,2008,2,NPS,16765,frijol
Sinaloa,727,568,2008,2,D1,159,frijol
Sonora,2171,1067,2008,2,D0,1104,frijol
Tabasco,7,7,2008,2,D0,0,frijol
Tamaulipas,3337,2608,2008,2,NPS,729,frijol
Tlaxcala,6658,6654,2008,2,NPS,4,frijol
Veracruz de Ignacio de la Llave,11769,8133,2008,2,NPS,3636,frijol
Zacatecas,537982,437358,2008,2,D1,100624,frijol
Coahuila de Zaragoza,9386,7278,2008,2,D1,2108,frijol
Coahuila de Zaragoza,26,19,2008,2,D1,7,frijol
Durango,9360,7259,2008,2,D1,2101,frijol
Ciudad de México,259,39,2008,7,D0,220,frijol
Chiapas,62336,8070,2008,8,NPS,54266,frijol
Ciudad de México,259,53,2008,8,D0,206,frijol
Puebla,50020,70,2008,8,NPS,49950,frijol
Quintana Roo,20,8,2008,8,NPS,12,frijol
Veracruz de Ignacio de la Llave,10426,265,2008,8,D0,10161,frijol
Zacatecas,479698,390,2008,8,NPS,479308,frijol
Chiapas,74308,23908,2008,9,NPS,50400,frijol
Ciudad de México,259,53,2008,9,D0,206,frijol
Guanajuato,84361,15,2008,9,NPS,84346,frijol
Guerrero,10137,212,2008,9,NPS,9925,frijol
Estado de México,13384,6,2008,9,D0,13378,frijol
Michoacán de Ocampo,3419,225,2008,9,D1,3194,frijol
Oaxaca,35778,480,2008,9,NPS,35298,frijol
Puebla,50020,1704,2008,9,NPS,48316,frijol
Quintana Roo,20,8,2008,9,NPS,12,frijol
San Luis Potosí,111749,120,2008,9,NPS,111629,frijol
Veracruz de Ignacio de la Llave,13126,2679,2008,9,D0,10447,frijol
Zacatecas,482361,510,2008,9,NPS,481851,frijol
Aguascalientes,10074,2741,2008,10,NPS,7333,frijol
Coahuila de Zaragoza,6304,806,2008,10,NPS,5498,frijol
Chiapas,74308,39144,2008,10,NPS,35164,frijol
Chihuahua,88806,29608,2008,10,NPS,59198,frijol
Ciudad de México,259,53,2008,10,D0,206,frijol
Durango,222749,2895,2008,10,NPS,219854,frijol
Guanajuato,85889,13727,2008,10,D0,72162,frijol
Guerrero,10137,1756,2008,10,NPS,8381,frijol
Hidalgo,33428,5620,2008,10,NPS,27808,frijol
Jalisco,10870,6195,2008,10,NPS,4675,frijol
Estado de México,13384,2258,2008,10,D0,11126,frijol
Michoacán de Ocampo,5928,794,2008,10,D1,5134,frijol
Morelos,1364,32,2008,10,NPS,1332,frijol
Nuevo León,2712,5,2008,10,NPS,2707,frijol
Oaxaca,35778,2969,2008,10,NPS,32809,frijol
Puebla,54441,19604,2008,10,NPS,34837,frijol
Querétaro de Arteaga,15835,276,2008,10,NPS,15559,frijol
Quintana Roo,20,12,2008,10,NPS,8,frijol
San Luis Potosí,111749,66202,2008,10,NPS,45547,frijol
Tlaxcala,6646,4446,2008,10,D1,2200,frijol
Veracruz de Ignacio de la Llave,13376,4537,2008,10,NPS,8839,frijol
Zacatecas,482361,79907,2008,10,NPS,402454,frijol
Coahuila de Zaragoza,7334,232,2008,10,NPS,7102,frijol
Aguascalientes,10074,6169,2008,11,NPS,3905,frijol
Baja California,475,8,2008,11,D2,467,frijol
Coahuila de Zaragoza,6304,4570,2008,11,NPS,1734,frijol
Colima,14,14,2008,11,D0,0,frijol
Chiapas,74308,42780,2008,11,NPS,31528,frijol
Chihuahua,88806,86317,2008,11,NPS,2489,frijol
Ciudad de México,259,145,2008,11,D1,114,frijol
Durango,222749,199057,2008,11,NPS,23692,frijol
Guanajuato,85901,28081,2008,11,D0,57820,frijol
Guerrero,10138,8935,2008,11,NPS,1203,frijol
Hidalgo,33428,18073,2008,11,NPS,15355,frijol
Jalisco,10942,6885,2008,11,D0,4057,frijol
Estado de México,13384,7274,2008,11,D1,6110,frijol
Michoacán de Ocampo,5928,1248,2008,11,D1,4680,frijol
Morelos,1364,199,2008,11,D0,1165,frijol
Nuevo León,2712,1825,2008,11,NPS,887,frijol
Oaxaca,35778,16057,2008,11,NPS,19721,frijol
Puebla,54441,40682,2008,11,NPS,13759,frijol
Querétaro de Arteaga,15835,6708,2008,11,NPS,9127,frijol
Quintana Roo,20,12,2008,11,NPS,8,frijol
San Luis Potosí,111749,96310,2008,11,NPS,15439,frijol
Sonora,1260,139,2008,11,NPS,1121,frijol
Tamaulipas,2182,267,2008,11,NPS,1915,frijol
Tlaxcala,6646,5800,2008,11,D1,846,frijol
Veracruz de Ignacio de la Llave,13376,9843,2008,11,NPS,3533,frijol
Zacatecas,482361,331008,2008,11,NPS,151353,frijol
Coahuila de Zaragoza,7334,3846,2008,11,NPS,3488,frijol
Coahuila de Zaragoza,232,232,2008,11,NPS,0,frijol
Durango,7102,3614,2008,11,NPS,3488,frijol
Aguascalientes,10074,7870,2009,1,NPS,2204,frijol
Baja California,475,8,2009,1,D1,467,frijol
Coahuila de Zaragoza,6304,4648,2009,1,D0,1656,frijol
Colima,14,14,2009,1,D0,0,frijol
Chiapas,74308,65848,2009,1,D0,8460,frijol
Chihuahua,88806,86317,2009,1,NPS,2489,frijol
Ciudad de México,259,259,2009,1,D2,0,frijol
Durango,222749,212683,2009,1,NPS,10066,frijol
Guanajuato,85901,58868,2009,1,D0,27033,frijol
Guerrero,10138,10138,2009,1,NPS,0,frijol
Hidalgo,33428,31011,2009,1,NPS,2417,frijol
Jalisco,10942,7500,2009,1,NPS,3442,frijol
Estado de México,13384,13384,2009,1,D1,0,frijol
Michoacán de Ocampo,5928,5833,2009,1,D1,95,frijol
Morelos,1364,840,2009,1,D0,524,frijol
Nayarit,409,409,2009,1,D0,0,frijol
Nuevo León,2712,2542,2009,1,NPS,170,frijol
Oaxaca,35778,31868,2009,1,NPS,3910,frijol
Puebla,54441,52858,2009,1,NPS,1583,frijol
Querétaro de Arteaga,15835,14558,2009,1,NPS,1277,frijol
Quintana Roo,20,12,2009,1,NPS,8,frijol
San Luis Potosí,111749,101387,2009,1,NPS,10362,frijol
Sinaloa,218,25,2009,1,D0,193,frijol
Sonora,1263,1036,2009,1,D0,227,frijol
Tamaulipas,2212,2121,2009,1,NPS,91,frijol
Tlaxcala,6646,6646,2009,1,D1,0,frijol
Veracruz de Ignacio de la Llave,13376,10822,2009,1,D0,2554,frijol
Zacatecas,482361,422145,2009,1,NPS,60216,frijol
Coahuila de Zaragoza,7334,7334,2009,1,D0,0,frijol
Coahuila de Zaragoza,232,232,2009,1,D0,0,frijol
Durango,7102,7102,2009,1,NPS,0,frijol
Aguascalientes,10074,7869,2009,2,NPS,2205,frijol
Baja California,475,8,2009,2,D1,467,frijol
Campeche,80,80,2009,2,D1,0,frijol
Coahuila de Zaragoza,6304,4648,2009,2,D0,1656,frijol
Colima,14,14,2009,2,D0,0,frijol
Chiapas,74308,67937,2009,2,D0,6371,frijol
Chihuahua,88806,86317,2009,2,NPS,2489,frijol
Ciudad de México,259,259,2009,2,D2,0,frijol
Durango,222749,212683,2009,2,NPS,10066,frijol
Guanajuato,85901,65470,2009,2,D0,20431,frijol
Guerrero,10154,10154,2009,2,NPS,0,frijol
Hidalgo,33428,31011,2009,2,NPS,2417,frijol
Jalisco,10942,7569,2009,2,NPS,3373,frijol
Estado de México,13384,13384,2009,2,D1,0,frijol
Michoacán de Ocampo,5928,5899,2009,2,D1,29,frijol
Morelos,1364,847,2009,2,D0,517,frijol
Nayarit,409,409,2009,2,D0,0,frijol
Nuevo León,2712,2542,2009,2,NPS,170,frijol
Oaxaca,35778,35778,2009,2,NPS,0,frijol
Puebla,54441,53026,2009,2,NPS,1415,frijol
Querétaro de Arteaga,15835,14970,2009,2,NPS,865,frijol
Quintana Roo,20,12,2009,2,D0,8,frijol
San Luis Potosí,111749,101387,2009,2,NPS,10362,frijol
Sinaloa,218,197,2009,2,D0,21,frijol
Sonora,1263,1111,2009,2,D0,152,frijol
Tamaulipas,2212,2121,2009,2,NPS,91,frijol
Tlaxcala,6646,6646,2009,2,D1,0,frijol
Veracruz de Ignacio de la Llave,13376,13042,2009,2,D0,334,frijol
Zacatecas,482361,422145,2009,2,NPS,60216,frijol
Coahuila de Zaragoza,7334,7334,2009,2,D0,0,frijol
Coahuila de Zaragoza,232,232,2009,2,D0,0,frijol
Durango,7102,7102,2009,2,NPS,0,frijol
Veracruz de Ignacio de la Llave,4254,125,2009,5,D0,4129,frijol
Veracruz de Ignacio de la Llave,7428,125,2009,6,D0,7303,frijol
Veracruz de Ignacio de la Llave,11554,816,2009,7,D0,10738,frijol
Baja California,470,10,2009,8,D2,460,frijol
Chiapas,59434,16789,2009,8,D1,42645,frijol
Ciudad de México,245,2,2009,8,D2,243,frijol
San Luis Potosí,103567,100,2009,8,NPS,103467,frijol
Veracruz de Ignacio de la Llave,13553,816,2009,8,D1,12737,frijol
Baja California,470,10,2009,9,D2,460,frijol
Chiapas,66976,31932,2009,9,D2,35044,frijol
Chihuahua,112219,400,2009,9,NPS,111819,frijol
Ciudad de México,245,2,2009,9,D1,243,frijol
Guerrero,9802,394,2009,9,NPS,9408,frijol
Hidalgo,31460,730,2009,9,NPS,30730,frijol
Jalisco,14159,4,2009,9,D1,14155,frijol
Michoacán de Ocampo,5770,30,2009,9,D2,5740,frijol
Puebla,59197,1345,2009,9,NPS,57852,frijol
San Luis Potosí,103567,100,2009,9,NPS,103467,frijol
Veracruz de Ignacio de la Llave,13553,3418,2009,9,NPS,10135,frijol
Baja California,470,10,2009,10,D2,460,frijol
Chiapas,72931,37432,2009,10,D2,35499,frijol
Chihuahua,112219,41603,2009,10,NPS,70616,frijol
Ciudad de México,245,32,2009,10,D1,213,frijol
Durango,222741,40069,2009,10,NPS,182672,frijol
Guanajuato,80348,2060,2009,10,D1,78288,frijol
Guerrero,9802,3871,2009,10,NPS,5931,frijol
Hidalgo,31460,1184,2009,10,NPS,30276,frijol
Jalisco,14179,4092,2009,10,D1,10087,frijol
Estado de México,13689,386,2009,10,D1,13303,frijol
Michoacán de Ocampo,5770,778,2009,10,D2,4992,frijol
Nayarit,304,182,2009,10,D1,122,frijol
Nuevo León,2966,980,2009,10,D0,1986,frijol
Oaxaca,34023,2576,2009,10,NPS,31447,frijol
Puebla,59197,7986,2009,10,NPS,51211,frijol
Querétaro de Arteaga,14924,222,2009,10,NPS,14702,frijol
San Luis Potosí,103567,1528,2009,10,NPS,102039,frijol
Tlaxcala,6619,3740,2009,10,D1,2879,frijol
Veracruz de Ignacio de la Llave,13651,6154,2009,10,NPS,7497,frijol
Zacatecas,505131,2155,2009,10,NPS,502976,frijol
Coahuila de Zaragoza,8673,235,2009,10,NPS,8438,frijol
Baja California,470,10,2009,11,D2,460,frijol
Coahuila de Zaragoza,4730,717,2009,11,D1,4013,frijol
Chiapas,74566,45019,2009,11,D2,29547,frijol
Chihuahua,112219,101786,2009,11,NPS,10433,frijol
Ciudad de México,245,123,2009,11,D1,122,frijol
Durango,222741,171218,2009,11,NPS,51523,frijol
Guanajuato,80348,10752,2009,11,D1,69596,frijol
Guerrero,9802,7316,2009,11,NPS,2486,frijol
Hidalgo,31460,14775,2009,11,NPS,16685,frijol
Jalisco,14179,4773,2009,11,D1,9406,frijol
Estado de México,13689,2275,2009,11,D1,11414,frijol
Michoacán de Ocampo,5770,1111,2009,11,D2,4659,frijol
Morelos,1736,1219,2009,11,D0,517,frijol
Nayarit,304,289,2009,11,D1,15,frijol
Nuevo León,2966,1640,2009,11,NPS,1326,frijol
Oaxaca,34023,15370,2009,11,NPS,18653,frijol
Puebla,59197,18639,2009,11,D0,40558,frijol
Querétaro de Arteaga,14924,1276,2009,11,NPS,13648,frijol
San Luis Potosí,103567,3052,2009,11,NPS,100515,frijol
Sinaloa,1013,90,2009,11,NPS,923,frijol
Sonora,1046,38,2009,11,D0,1008,frijol
Tlaxcala,6619,5288,2009,11,D0,1331,frijol
Veracruz de Ignacio de la Llave,13651,9376,2009,11,NPS,4275,frijol
Zacatecas,505131,238306,2009,11,NPS,266825,frijol
Coahuila de Zaragoza,8673,2508,2009,11,D1,6165,frijol
Aguascalientes,8854,582,2010,1,NPS,8272,frijol
Baja California,470,10,2010,1,D0,460,frijol
Coahuila de Zaragoza,4730,1206,2010,1,D0,3524,frijol
Chiapas,74566,67005,2010,1,D2,7561,frijol
Chihuahua,112219,109255,2010,1,NPS,2964,frijol
Ciudad de México,245,245,2010,1,D0,0,frijol
Durango,222741,203618,2010,1,NPS,19123,frijol
Guanajuato,80348,20262,2010,1,D1,60086,frijol
Guerrero,9802,9712,2010,1,NPS,90,frijol
Hidalgo,31460,17770,2010,1,NPS,13690,frijol
Jalisco,14221,5177,2010,1,D2,9044,frijol
Estado de México,13689,12739,2010,1,D0,950,frijol
Michoacán de Ocampo,5772,5212,2010,1,D1,560,frijol
Morelos,1736,1233,2010,1,D0,503,frijol
Nayarit,304,304,2010,1,NPS,0,frijol
Nuevo León,3055,2767,2010,1,NPS,288,frijol
Oaxaca,34023,20939,2010,1,NPS,13084,frijol
Puebla,59197,21008,2010,1,NPS,38189,frijol
Querétaro de Arteaga,14924,4396,2010,1,NPS,10528,frijol
San Luis Potosí,103567,5168,2010,1,NPS,98399,frijol
Sinaloa,1013,470,2010,1,NPS,543,frijol
Sonora,1071,801,2010,1,D0,270,frijol
Tamaulipas,5766,1918,2010,1,NPS,3848,frijol
Tlaxcala,6619,6609,2010,1,NPS,10,frijol
Veracruz de Ignacio de la Llave,13651,10035,2010,1,NPS,3616,frijol
Yucatán,16,16,2010,1,D3,0,frijol
Zacatecas,505131,311951,2010,1,NPS,193180,frijol
Coahuila de Zaragoza,8673,3239,2010,1,D0,5434,frijol
Aguascalientes,8854,582,2010,2,NPS,8272,frijol
Baja California,470,10,2010,2,NPS,460,frijol
Campeche,80,80,2010,2,D2,0,frijol
Coahuila de Zaragoza,4730,1206,2010,2,NPS,3524,frijol
Chiapas,74566,74356,2010,2,D3,210,frijol
Chihuahua,112219,109255,2010,2,NPS,2964,frijol
Ciudad de México,245,245,2010,2,D0,0,frijol
Durango,222741,203618,2010,2,NPS,19123,frijol
Guanajuato,80348,20262,2010,2,NPS,60086,frijol
Guerrero,9802,9712,2010,2,NPS,90,frijol
Hidalgo,31460,17770,2010,2,NPS,13690,frijol
Jalisco,14221,5366,2010,2,NPS,8855,frijol
Estado de México,13689,13156,2010,2,NPS,533,frijol
Michoacán de Ocampo,5772,5278,2010,2,NPS,494,frijol
Morelos,1736,1736,2010,2,D0,0,frijol
Nayarit,304,304,2010,2,NPS,0,frijol
Nuevo León,3055,2956,2010,2,NPS,99,frijol
Oaxaca,34023,28306,2010,2,NPS,5717,frijol
Puebla,59197,21271,2010,2,NPS,37926,frijol
Querétaro de Arteaga,14924,5317,2010,2,NPS,9607,frijol
Quintana Roo,10,5,2010,2,D1,5,frijol
San Luis Potosí,103567,5168,2010,2,NPS,98399,frijol
Sinaloa,1013,470,2010,2,NPS,543,frijol
Sonora,1071,801,2010,2,NPS,270,frijol
Tamaulipas,5766,3776,2010,2,NPS,1990,frijol
Tlaxcala,6619,6609,2010,2,NPS,10,frijol
Veracruz de Ignacio de la Llave,13651,10065,2010,2,NPS,3586,frijol
Yucatán,16,16,2010,2,D3,0,frijol
Zacatecas,505131,311951,2010,2,NPS,193180,frijol
Coahuila de Zaragoza,8673,3239,2010,2,NPS,5434,frijol
Chiapas,61675,4158,2010,7,NPS,57517,frijol
Chiapas,65685,9739,2010,8,NPS,55946,frijol
Estado de México,11720,2,2010,8,NPS,11718,frijol
Veracruz de Ignacio de la Llave,10750,150,2010,8,NPS,10600,frijol
Baja California,976,800,2010,9,NPS,176,frijol
Chiapas,68291,16222,2010,9,NPS,52069,frijol
Ciudad de México,244,11,2010,9,NPS,233,frijol
Hidalgo,36515,512,2010,9,NPS,36003,frijol
Jalisco,13924,50,2010,9,NPS,13874,frijol
Estado de México,11860,33,2010,9,NPS,11827,frijol
Puebla,57994,995,2010,9,NPS,56999,frijol
Quintana Roo,16,4,2010,9,NPS,12,frijol
San Luis Potosí,120804,6250,2010,9,NPS,114554,frijol
Veracruz de Ignacio de la Llave,11999,3478,2010,9,NPS,8521,frijol
Baja California,976,800,2010,10,NPS,176,frijol
Coahuila de Zaragoza,6638,146,2010,10,NPS,6492,frijol
Colima,13,13,2010,10,NPS,0,frijol
Chiapas,70593,34354,2010,10,NPS,36239,frijol
Chihuahua,127004,40786,2010,10,D0,86218,frijol
Ciudad de México,244,50,2010,10,NPS,194,frijol
Durango,236190,41116,2010,10,NPS,195074,frijol
Guanajuato,82944,5842,2010,10,NPS,77102,frijol
Guerrero,10008,4196,2010,10,NPS,5812,frijol
Hidalgo,36515,4001,2010,10,NPS,32514,frijol
Jalisco,13924,5771,2010,10,NPS,8153,frijol
Estado de México,11860,409,2010,10,NPS,11451,frijol
Michoacán de Ocampo,7061,1021,2010,10,NPS,6040,frijol
Morelos,1890,10,2010,10,NPS,1880,frijol
Nayarit,216,14,2010,10,NPS,202,frijol
Oaxaca,36486,2523,2010,10,NPS,33963,frijol
Puebla,57994,1297,2010,10,NPS,56697,frijol
Quintana Roo,16,6,2010,10,D0,10,frijol
San Luis Potosí,120804,48530,2010,10,NPS,72274,frijol
Tabasco,5,4,2010,10,NPS,1,frijol
Tamaulipas,4060,210,2010,10,NPS,3850,frijol
Tlaxcala,6580,4648,2010,10,NPS,1932,frijol
Veracruz de Ignacio de la Llave,12160,6626,2010,10,NPS,5534,frijol
Zacatecas,578622,10991,2010,10,NPS,567631,frijol
Aguascalientes,10414,5223,2010,11,NPS,5191,frijol
Baja California,976,826,2010,11,NPS,150,frijol
Coahuila de Zaragoza,6638,577,2010,11,D2,6061,frijol
Colima,13,13,2010,11,D0,0,frijol
Chiapas,70593,40602,2010,11,NPS,29991,frijol
Chihuahua,127004,71125,2010,11,NPS,55879,frijol
Ciudad de México,246,149,2010,11,NPS,97,frijol
Durango,236190,168752,2010,11,NPS,67438,frijol
Guanajuato,82944,39132,2010,11,NPS,43812,frijol
Guerrero,10008,6938,2010,11,NPS,3070,frijol
Hidalgo,36527,23170,2010,11,NPS,13357,frijol
Jalisco,13924,8491,2010,11,NPS,5433,frijol
Estado de México,11860,3612,2010,11,NPS,8248,frijol
Michoacán de Ocampo,7061,1684,2010,11,NPS,5377,frijol
Morelos,1890,928,2010,11,NPS,962,frijol
Nayarit,216,197,2010,11,NPS,19,frijol
Nuevo León,4758,1950,2010,11,NPS,2808,frijol
Oaxaca,36486,12633,2010,11,NPS,23853,frijol
Puebla,58024,36190,2010,11,NPS,21834,frijol
Querétaro de Arteaga,13919,4932,2010,11,NPS,8987,frijol
Quintana Roo,16,8,2010,11,NPS,8,frijol
San Luis Potosí,120804,78431,2010,11,NPS,42373,frijol
Sonora,1132,4,2010,11,NPS,1128,frijol
Tabasco,5,4,2010,11,NPS,1,frijol
Tamaulipas,4060,210,2010,11,NPS,3850,frijol
Tlaxcala,6580,5755,2010,11,NPS,825,frijol
Veracruz de Ignacio de la Llave,12160,9046,2010,11,NPS,3114,frijol
Yucatán,15,15,2010,11,D0,0,frijol
Zacatecas,578622,381583,2010,11,NPS,197039,frijol
Coahuila de Zaragoza,9952,606,2010,11,D2,9346,frijol
Aguascalientes,10414,5341,2011,1,NPS,5073,frijol
Baja California,976,826,2011,1,NPS,150,frijol
Campeche,80,80,2011,1,NPS,0,frijol
Coahuila de Zaragoza,6638,6544,2011,1,D0,94,frijol
Colima,13,13,2011,1,D0,0,frijol
Chiapas,70594,67425,2011,1,NPS,3169,frijol
Chihuahua,127004,124814,2011,1,D0,2190,frijol
Ciudad de México,246,246,2011,1,NPS,0,frijol
Durango,236190,201265,2011,1,NPS,34925,frijol
Guanajuato,82944,57295,2011,1,D0,25649,frijol
Guerrero,10008,9794,2011,1,NPS,214,frijol
Hidalgo,36527,24267,2011,1,NPS,12260,frijol
Jalisco,13924,9098,2011,1,D0,4826,frijol
Estado de México,11860,9095,2011,1,NPS,2765,frijol
Michoacán de Ocampo,7061,6446,2011,1,D0,615,frijol
Morelos,1890,1574,2011,1,NPS,316,frijol
Nayarit,216,211,2011,1,D0,5,frijol
Nuevo León,4851,3850,2011,1,NPS,1001,frijol
Oaxaca,36486,24314,2011,1,NPS,12172,frijol
Puebla,58024,51430,2011,1,NPS,6594,frijol
Querétaro de Arteaga,14399,7304,2011,1,NPS,7095,frijol
Quintana Roo,16,14,2011,1,NPS,2,frijol
San Luis Potosí,120804,84389,2011,1,NPS,36415,frijol
Sinaloa,686,185,2011,1,D0,501,frijol
Sonora,1132,22,2011,1,D0,1110,frijol
Tabasco,5,4,2011,1,NPS,1,frijol
Tamaulipas,4060,3630,2011,1,NPS,430,frijol
Tlaxcala,6580,6580,2011,1,NPS,0,frijol
Veracruz de Ignacio de la Llave,12160,11727,2011,1,NPS,433,frijol
Yucatán,15,15,2011,1,NPS,0,frijol
Zacatecas,578622,476779,2011,1,NPS,101843,frijol
Coahuila de Zaragoza,9952,6822,2011,1,D0,3130,frijol
Aguascalientes,10414,5341,2011,2,NPS,5073,frijol
Baja California,976,826,2011,2,NPS,150,frijol
Campeche,80,80,2011,2,D0,0,frijol
Coahuila de Zaragoza,6638,6544,2011,2,NPS,94,frijol
Colima,13,13,2011,2,NPS,0,frijol
Chiapas,70594,70572,2011,2,NPS,22,frijol
Chihuahua,127004,124814,2011,2,D0,2190,frijol
Ciudad de México,246,246,2011,2,NPS,0,frijol
Durango,236190,201449,2011,2,NPS,34741,frijol
Guanajuato,82944,57295,2011,2,NPS,25649,frijol
Guerrero,10008,9794,2011,2,NPS,214,frijol
Hidalgo,36527,24267,2011,2,NPS,12260,frijol
Jalisco,13924,9122,2011,2,D0,4802,frijol
Estado de México,11860,9097,2011,2,NPS,2763,frijol
Michoacán de Ocampo,7061,6623,2011,2,D0,438,frijol
Morelos,1890,1799,2011,2,NPS,91,frijol
Nayarit,216,211,2011,2,D0,5,frijol
Nuevo León,4852,3850,2011,2,NPS,1002,frijol
Oaxaca,36486,26027,2011,2,NPS,10459,frijol
Puebla,58024,52566,2011,2,NPS,5458,frijol
Querétaro de Arteaga,14399,7701,2011,2,NPS,6698,frijol
Quintana Roo,16,16,2011,2,D0,0,frijol
San Luis Potosí,120804,84389,2011,2,NPS,36415,frijol
Sinaloa,686,185,2011,2,D0,501,frijol
Sonora,1132,1022,2011,2,D2,110,frijol
Tabasco,5,4,2011,2,NPS,1,frijol
Tamaulipas,4060,3664,2011,2,NPS,396,frijol
Tlaxcala,6580,6580,2011,2,NPS,0,frijol
Veracruz de Ignacio de la Llave,12160,11747,2011,2,NPS,413,frijol
Yucatán,15,15,2011,2,D0,0,frijol
Zacatecas,578622,481715,2011,2,NPS,96907,frijol
Coahuila de Zaragoza,9952,7006,2011,2,NPS,2946,frijol
Veracruz de Ignacio de la Llave,6662,125,2011,6,D3,6537,frijol
Chiapas,61158,1132,2011,7,NPS,60026,frijol
Ciudad de México,239,10,2011,7,D1,229,frijol
Veracruz de Ignacio de la Llave,10408,150,2011,7,D1,10258,frijol
Chiapas,63277,9092,2011,8,NPS,54185,frijol
Ciudad de México,239,29,2011,8,D1,210,frijol
Hidalgo,28165,70,2011,8,D1,28095,frijol
Puebla,54456,265,2011,8,D0,54191,frijol
Tlaxcala,6446,5,2011,8,D1,6441,frijol
Veracruz de Ignacio de la Llave,11706,425,2011,8,D1,11281,frijol
Baja California,13,13,2011,9,NPS,0,frijol
Chiapas,68485,26647,2011,9,NPS,41838,frijol
Ciudad de México,239,35,2011,9,NPS,204,frijol
Guanajuato,75359,1440,2011,9,D2,73919,frijol
Guerrero,9930,1606,2011,9,NPS,8324,frijol
Hidalgo,28596,527,2011,9,NPS,28069,frijol
Estado de México,7049,23,2011,9,NPS,7026,frijol
Puebla,54456,400,2011,9,NPS,54056,frijol
Tlaxcala,6446,5,2011,9,NPS,6441,frijol
Veracruz de Ignacio de la Llave,11731,1081,2011,9,NPS,10650,frijol
Baja California,13,13,2011,10,D0,0,frijol
Chiapas,73892,37848,2011,10,NPS,36044,frijol
Chihuahua,77638,13536,2011,10,D3,64102,frijol
Ciudad de México,239,55,2011,10,D0,184,frijol
Durango,198077,641,2011,10,D3,197436,frijol
Guanajuato,75359,5936,2011,10,D2,69423,frijol
Guerrero,9930,2202,2011,10,NPS,7728,frijol
Hidalgo,28596,1593,2011,10,D0,27003,frijol
Jalisco,13784,217,2011,10,D2,13567,frijol
Estado de México,7125,1292,2011,10,D0,5833,frijol
Michoacán de Ocampo,3800,112,2011,10,D0,3688,frijol
Morelos,1667,13,2011,10,NPS,1654,frijol
Nayarit,230,129,2011,10,NPS,101,frijol
Oaxaca,36978,1308,2011,10,NPS,35670,frijol
Puebla,54456,4783,2011,10,NPS,49673,frijol
Querétaro de Arteaga,12413,4,2011,10,D2,12409,frijol
San Luis Potosí,54689,72,2011,10,D1,54617,frijol
Sonora,435,36,2011,10,D3,399,frijol
Tlaxcala,6482,1820,2011,10,NPS,4662,frijol
Veracruz de Ignacio de la Llave,11731,2940,2011,10,D0,8791,frijol
Aguascalientes,4778,200,2011,11,D3,4578,frijol
Baja California,13,13,2011,11,NPS,0,frijol
Coahuila de Zaragoza,4818,627,2011,11,D4,4191,frijol
Chiapas,73892,47739,2011,11,NPS,26153,frijol
Chihuahua,77638,50273,2011,11,D3,27365,frijol
Ciudad de México,239,145,2011,11,D0,94,frijol
Durango,198077,91681,2011,11,D3,106396,frijol
Guanajuato,75359,11091,2011,11,D2,64268,frijol
Guerrero,9932,8358,2011,11,NPS,1574,frijol
Hidalgo,28596,13777,2011,11,D0,14819,frijol
Jalisco,13784,1787,2011,11,D2,11997,frijol
Estado de México,7125,2836,2011,11,D0,4289,frijol
Michoacán de Ocampo,3800,1488,2011,11,D0,2312,frijol
Morelos,1667,890,2011,11,NPS,777,frijol
Nayarit,230,129,2011,11,NPS,101,frijol
Nuevo León,1063,85,2011,11,D3,978,frijol
Oaxaca,36978,13173,2011,11,NPS,23805,frijol
Puebla,54456,33176,2011,11,NPS,21280,frijol
Querétaro de Arteaga,12413,962,2011,11,D2,11451,frijol
Quintana Roo,18,4,2011,11,NPS,14,frijol
San Luis Potosí,54689,3239,2011,11,D2,51450,frijol
Sinaloa,671,59,2011,11,D1,612,frijol
Sonora,1071,71,2011,11,D0,1000,frijol
Tamaulipas,1070,8,2011,11,D1,1062,frijol
Tlaxcala,6482,2209,2011,11,NPS,4273,frijol
Veracruz de Ignacio de la Llave,11731,7254,2011,11,D0,4477,frijol
Zacatecas,480981,180272,2011,11,D3,300709,frijol
Aguascalientes,4778,200,2012,1,D3,4578,frijol
Baja California,13,13,2012,1,NPS,0,frijol
Coahuila de Zaragoza,4818,627,2012,1,D3,4191,frijol
Colima,4,4,2012,1,D0,0,frijol
Chiapas,76892,67831,2012,1,NPS,9061,frijol
Chihuahua,77638,50382,2012,1,D3,27256,frijol
Ciudad de México,239,239,2012,1,D0,0,frijol
Durango,198077,117493,2012,1,D3,80584,frijol
Guanajuato,75359,22309,2012,1,D2,53050,frijol
Guerrero,9932,9927,2012,1,NPS,5,frijol
Hidalgo,28596,15338,2012,1,D0,13258,frijol
Jalisco,13784,2782,2012,1,D1,11002,frijol
Estado de México,7125,5639,2012,1,D0,1486,frijol
Michoacán de Ocampo,3800,3485,2012,1,D1,315,frijol
Morelos,1667,1439,2012,1,NPS,228,frijol
Nayarit,230,226,2012,1,D1,4,frijol
Nuevo León,1063,435,2012,1,D2,628,frijol
Oaxaca,36978,34309,2012,1,NPS,2669,frijol
Puebla,54456,36630,2012,1,NPS,17826,frijol
Querétaro de Arteaga,12413,2004,2012,1,D1,10409,frijol
Quintana Roo,18,12,2012,1,NPS,6,frijol
San Luis Potosí,54689,6564,2012,1,D0,48125,frijol
Sinaloa,671,539,2012,1,D1,132,frijol
Sonora,1083,1008,2012,1,D0,75,frijol
Tabasco,4,4,2012,1,NPS,0,frijol
Tamaulipas,1070,168,2012,1,D0,902,frijol
Tlaxcala,6482,2547,2012,1,NPS,3935,frijol
Veracruz de Ignacio de la Llave,11736,10314,2012,1,NPS,1422,frijol
Yucatán,2,2,2012,1,NPS,0,frijol
Zacatecas,480981,200048,2012,1,D3,280933,frijol
Aguascalientes,4778,200,2012,2,D1,4578,frijol
Baja California,13,13,2012,2,NPS,0,frijol
Campeche,72,72,2012,2,NPS,0,frijol
Coahuila de Zaragoza,4818,627,2012,2,D3,4191,frijol
Colima,4,4,2012,2,NPS,0,frijol
Chiapas,76892,73181,2012,2,NPS,3711,frijol
Chihuahua,77638,50382,2012,2,D3,27256,frijol
Ciudad de México,239,239,2012,2,NPS,0,frijol
Durango,198077,117493,2012,2,D3,80584,frijol
Guanajuato,75359,22309,2012,2,D1,53050,frijol
Guerrero,9932,9928,2012,2,NPS,4,frijol
Hidalgo,28596,15338,2012,2,NPS,13258,frijol
Jalisco,13784,2940,2012,2,NPS,10844,frijol
Estado de México,7125,5639,2012,2,NPS,1486,frijol
Michoacán de Ocampo,3800,3751,2012,2,NPS,49,frijol
Morelos,1667,1667,2012,2,NPS,0,frijol
Nayarit,230,226,2012,2,D0,4,frijol
Nuevo León,1063,735,2012,2,D2,328,frijol
Oaxaca,36978,36388,2012,2,NPS,590,frijol
Puebla,54456,40009,2012,2,NPS,14447,frijol
Querétaro de Arteaga,12413,2250,2012,2,D1,10163,frijol
Quintana Roo,18,18,2012,2,NPS,0,frijol
San Luis Potosí,54689,6654,2012,2,NPS,48035,frijol
Sinaloa,671,645,2012,2,D1,26,frijol
Sonora,1083,1083,2012,2,D0,0,frijol
Tabasco,4,4,2012,2,NPS,0,frijol
Tamaulipas,1070,662,2012,2,NPS,408,frijol
Tlaxcala,6482,2547,2012,2,NPS,3935,frijol
Veracruz de Ignacio de la Llave,11736,10733,2012,2,NPS,1003,frijol
Yucatán,32,32,2012,2,NPS,0,frijol
Zacatecas,480981,200049,2012,2,D1,280932,frijol
Veracruz de Ignacio de la Llave,11032,125,2012,6,NPS,10907,frijol
Chihuahua,96815,110,2012,7,D1,96705,frijol
Ciudad de México,115,10,2012,7,NPS,105,frijol
Veracruz de Ignacio de la Llave,11592,335,2012,7,NPS,11257,frijol
Chiapas,65732,18041,2012,8,NPS,47691,frijol
Chihuahua,111653,110,2012,8,D1,111543,frijol
Ciudad de México,115,22,2012,8,NPS,93,frijol
Guerrero,9868,54,2012,8,NPS,9814,frijol
Hidalgo,24805,490,2012,8,NPS,24315,frijol
Estado de México,9484,5,2012,8,NPS,9479,frijol
Veracruz de Ignacio de la Llave,12482,1018,2012,8,NPS,11464,frijol
Baja California,38,2,2012,9,NPS,36,frijol
Chiapas,70700,34547,2012,9,NPS,36153,frijol
Chihuahua,122112,138,2012,9,D1,121974,frijol
Ciudad de México,115,39,2012,9,NPS,76,frijol
Guanajuato,86967,550,2012,9,NPS,86417,frijol
Guerrero,10446,1407,2012,9,NPS,9039,frijol
Hidalgo,24805,939,2012,9,NPS,23866,frijol
Estado de México,9609,10,2012,9,NPS,9599,frijol
Nuevo León,2203,80,2012,9,D0,2123,frijol
Oaxaca,36255,52,2012,9,NPS,36203,frijol
Puebla,55388,2276,2012,9,NPS,53112,frijol
Tabasco,5,1,2012,9,NPS,4,frijol
Veracruz de Ignacio de la Llave,13250,4164,2012,9,NPS,9086,frijol
Aguascalientes,9280,2011,2012,10,NPS,7269,frijol
Baja California,38,2,2012,10,NPS,36,frijol
Chiapas,73425,47255,2012,10,NPS,26170,frijol
Chihuahua,123553,9241,2012,10,D0,114312,frijol
Ciudad de México,115,39,2012,10,NPS,76,frijol
Durango,244310,25522,2012,10,D0,218788,frijol
Guanajuato,86967,21732,2012,10,NPS,65235,frijol
Guerrero,10446,3491,2012,10,NPS,6955,frijol
Hidalgo,24805,3081,2012,10,NPS,21724,frijol
Jalisco,13964,3394,2012,10,NPS,10570,frijol
Estado de México,9619,3276,2012,10,NPS,6343,frijol
Michoacán de Ocampo,3371,483,2012,10,NPS,2888,frijol
Nayarit,183,39,2012,10,NPS,144,frijol
Nuevo León,2431,695,2012,10,NPS,1736,frijol
Oaxaca,36255,8772,2012,10,NPS,27483,frijol
Puebla,55388,6103,2012,10,NPS,49285,frijol
Querétaro de Arteaga,11353,2399,2012,10,NPS,8954,frijol
Quintana Roo,18,2,2012,10,NPS,16,frijol
San Luis Potosí,95157,17788,2012,10,NPS,77369,frijol
Sonora,1137,29,2012,10,NPS,1108,frijol
Tabasco,5,5,2012,10,NPS,0,frijol
Tlaxcala,5021,3540,2012,10,NPS,1481,frijol
Veracruz de Ignacio de la Llave,13250,5816,2012,10,NPS,7434,frijol
Zacatecas,535128,1952,2012,10,NPS,533176,frijol
Aguascalientes,9280,5691,2012,11,NPS,3589,frijol
Baja California,38,2,2012,11,D0,36,frijol
Coahuila de Zaragoza,3689,1650,2012,11,D1,2039,frijol
Chiapas,73425,52214,2012,11,NPS,21211,frijol
Chihuahua,123553,119928,2012,11,NPS,3625,frijol
Ciudad de México,115,81,2012,11,NPS,34,frijol
Durango,244310,205506,2012,11,NPS,38804,frijol
Guanajuato,86967,52703,2012,11,NPS,34264,frijol
Guerrero,10446,7393,2012,11,NPS,3053,frijol
Hidalgo,24805,17014,2012,11,NPS,7791,frijol
Jalisco,13964,10219,2012,11,NPS,3745,frijol
Estado de México,9619,8122,2012,11,NPS,1497,frijol
Michoacán de Ocampo,4051,2241,2012,11,NPS,1810,frijol
Morelos,1619,355,2012,11,NPS,1264,frijol
Nayarit,183,170,2012,11,NPS,13,frijol
Nuevo León,2431,825,2012,11,D0,1606,frijol
Oaxaca,36255,21281,2012,11,NPS,14974,frijol
Puebla,55388,40038,2012,11,NPS,15350,frijol
Querétaro de Arteaga,11353,6486,2012,11,NPS,4867,frijol
Quintana Roo,18,6,2012,11,NPS,12,frijol
San Luis Potosí,95157,72865,2012,11,D0,22292,frijol
Sinaloa,470,90,2012,11,NPS,380,frijol
Sonora,1148,136,2012,11,D1,1012,frijol
Tabasco,83,83,2012,11,NPS,0,frijol
Tamaulipas,1988,413,2012,11,NPS,1575,frijol
Tlaxcala,5021,4638,2012,11,NPS,383,frijol
Veracruz de Ignacio de la Llave,13250,8576,2012,11,NPS,4674,frijol
Zacatecas,535128,182946,2012,11,D0,352182,frijol
Coahuila de Zaragoza,9002,6140,2012,11,D1,2862,frijol
Aguascalientes,9280,5691,2013,1,NPS,3589,frijol
Baja California,38,2,2013,1,D0,36,frijol
Coahuila de Zaragoza,3689,1654,2013,1,D1,2035,frijol
Colima,18,18,2013,1,NPS,0,frijol
Chiapas,73425,73425,2013,1,NPS,0,frijol
Chihuahua,123553,119928,2013,1,NPS,3625,frijol
Ciudad de México,115,115,2013,1,NPS,0,frijol
Durango,244310,233985,2013,1,NPS,10325,frijol
Guanajuato,86967,67828,2013,1,NPS,19139,frijol
Guerrero,10446,10399,2013,1,NPS,47,frijol
Hidalgo,24805,23603,2013,1,NPS,1202,frijol
Jalisco,13964,13145,2013,1,NPS,819,frijol
Estado de México,9619,9609,2013,1,NPS,10,frijol
Michoacán de Ocampo,4051,3690,2013,1,NPS,361,frijol
Morelos,1635,1524,2013,1,NPS,111,frijol
Nayarit,183,176,2013,1,NPS,7,frijol
Nuevo León,2431,1354,2013,1,D1,1077,frijol
Oaxaca,36255,36240,2013,1,NPS,15,frijol
Puebla,55388,54732,2013,1,NPS,656,frijol
Querétaro de Arteaga,11353,10827,2013,1,NPS,526,frijol
Quintana Roo,18,15,2013,1,NPS,3,frijol
San Luis Potosí,95157,74624,2013,1,NPS,20533,frijol
Sinaloa,470,465,2013,1,NPS,5,frijol
Sonora,1148,1137,2013,1,D1,11,frijol
Tabasco,83,83,2013,1,NPS,0,frijol
Tamaulipas,1988,1217,2013,1,D0,771,frijol
Tlaxcala,5021,5006,2013,1,NPS,15,frijol
Veracruz de Ignacio de la Llave,13250,12789,2013,1,NPS,461,frijol
Yucatán,52,22,2013,1,NPS,30,frijol
Zacatecas,535128,466161,2013,1,NPS,68967,frijol
Coahuila de Zaragoza,9002,8616,2013,1,D1,386,frijol
Aguascalientes,9280,5691,2013,2,NPS,3589,frijol
Baja California,38,2,2013,2,D0,36,frijol
Coahuila de Zaragoza,3689,1654,2013,2,D1,2035,frijol
Colima,18,18,2013,2,NPS,0,frijol
Chiapas,73425,73425,2013,2,NPS,0,frijol
Chihuahua,123553,119928,2013,2,NPS,3625,frijol
Ciudad de México,115,115,2013,2,D0,0,frijol
Durango,244310,233985,2013,2,NPS,10325,frijol
Guanajuato,86967,67828,2013,2,D0,19139,frijol
Guerrero,10446,10434,2013,2,NPS,12,frijol
Hidalgo,24805,23603,2013,2,NPS,1202,frijol
Jalisco,13964,13160,2013,2,NPS,804,frijol
Estado de México,9619,9609,2013,2,NPS,10,frijol
Michoacán de Ocampo,4051,4051,2013,2,D0,0,frijol
Morelos,1635,1634,2013,2,NPS,1,frijol
Nayarit,183,176,2013,2,D1,7,frijol
Nuevo León,2431,1354,2013,2,D0,1077,frijol
Oaxaca,36255,36240,2013,2,NPS,15,frijol
Puebla,55388,55318,2013,2,NPS,70,frijol
Querétaro de Arteaga,11353,10831,2013,2,NPS,522,frijol
Quintana Roo,18,18,2013,2,NPS,0,frijol
San Luis Potosí,95157,74714,2013,2,NPS,20443,frijol
Sinaloa,470,465,2013,2,NPS,5,frijol
Sonora,1148,1137,2013,2,D1,11,frijol
Tabasco,83,83,2013,2,D0,0,frijol
Tamaulipas,1988,1259,2013,2,NPS,729,frijol
Tlaxcala,5021,5006,2013,2,D0,15,frijol
Veracruz de Ignacio de la Llave,13250,12790,2013,2,NPS,460,frijol
Yucatán,52,52,2013,2,NPS,0,frijol
Zacatecas,535128,466161,2013,2,NPS,68967,frijol
Coahuila de Zaragoza,9002,8616,2013,2,D1,386,frijol
Ciudad de México,105,3,2013,6,NPS,102,frijol
Veracruz de Ignacio de la Llave,9294,125,2013,6,NPS,9169,frijol
Ciudad de México,105,16,2013,7,D0,89,frijol
Veracruz de Ignacio de la Llave,10693,255,2013,7,NPS,10438,frijol
Chiapas,64005,5016,2013,8,NPS,58989,frijol
Ciudad de México,105,29,2013,8,NPS,76,frijol
Guerrero,10313,39,2013,8,D0,10274,frijol
Hidalgo,23784,902,2013,8,NPS,22882,frijol
Estado de México,9589,75,2013,8,NPS,9514,frijol
Veracruz de Ignacio de la Llave,12963,2507,2013,8,NPS,10456,frijol
Zacatecas,599548,9100,2013,8,NPS,590448,frijol
Aguascalientes,9436,69,2013,9,NPS,9367,frijol
Coahuila de Zaragoza,3182,126,2013,9,NPS,3056,frijol
Chiapas,70716,35360,2013,9,NPS,35356,frijol
Ciudad de México,105,30,2013,9,NPS,75,frijol
Guanajuato,81597,1917,2013,9,NPS,79680,frijol
Guerrero,10929,360,2013,9,NPS,10569,frijol
Hidalgo,23784,1166,2013,9,NPS,22618,frijol
Jalisco,14312,16,2013,9,NPS,14296,frijol
Estado de México,9802,75,2013,9,NPS,9727,frijol
Nuevo León,1905,100,2013,9,NPS,1805,frijol
Oaxaca,35809,70,2013,9,NPS,35739,frijol
Puebla,58881,1743,2013,9,NPS,57138,frijol
Quintana Roo,30,6,2013,9,NPS,24,frijol
San Luis Potosí,123849,68,2013,9,NPS,123781,frijol
Tabasco,80,25,2013,9,NPS,55,frijol
Veracruz de Ignacio de la Llave,13028,3816,2013,9,NPS,9212,frijol
Zacatecas,639548,8518,2013,9,NPS,631030,frijol
Aguascalientes,9436,7509,2013,10,NPS,1927,frijol
Baja California,621,18,2013,10,D1,603,frijol
Coahuila de Zaragoza,3293,126,2013,10,NPS,3167,frijol
Chiapas,74716,41340,2013,10,NPS,33376,frijol
Chihuahua,103078,8134,2013,10,NPS,94944,frijol
Ciudad de México,105,63,2013,10,NPS,42,frijol
Guanajuato,81597,26053,2013,10,NPS,55544,frijol
Guerrero,10929,703,2013,10,NPS,10226,frijol
Hidalgo,23784,4178,2013,10,NPS,19606,frijol
Jalisco,14320,11989,2013,10,NPS,2331,frijol
Estado de México,9802,1059,2013,10,NPS,8743,frijol
Michoacán de Ocampo,3598,889,2013,10,NPS,2709,frijol
Nayarit,260,64,2013,10,D0,196,frijol
Nuevo León,1982,475,2013,10,NPS,1507,frijol
Oaxaca,35809,8058,2013,10,NPS,27751,frijol
Puebla,58881,21751,2013,10,NPS,37130,frijol
Querétaro de Arteaga,10805,1961,2013,10,NPS,8844,frijol
Quintana Roo,30,18,2013,10,NPS,12,frijol
San Luis Potosí,123849,12613,2013,10,NPS,111236,frijol
Sonora,975,30,2013,10,NPS,945,frijol
Tabasco,80,80,2013,10,NPS,0,frijol
Tlaxcala,4849,3153,2013,10,NPS,1696,frijol
Veracruz de Ignacio de la Llave,13028,5619,2013,10,NPS,7409,frijol
Zacatecas,649208,38026,2013,10,NPS,611182,frijol
Aguascalientes,9436,8144,2013,11,NPS,1292,frijol
Baja California,621,18,2013,11,NPS,603,frijol
Coahuila de Zaragoza,4237,2326,2013,11,NPS,1911,frijol
Chiapas,74716,49187,2013,11,NPS,25529,frijol
Chihuahua,103078,87590,2013,11,NPS,15488,frijol
Ciudad de México,105,78,2013,11,NPS,27,frijol
Durango,250132,196600,2013,11,NPS,53532,frijol
Guanajuato,81597,62315,2013,11,NPS,19282,frijol
Guerrero,10929,6600,2013,11,NPS,4329,frijol
Hidalgo,23784,19265,2013,11,NPS,4519,frijol
Jalisco,14320,13708,2013,11,NPS,612,frijol
Estado de México,9802,5449,2013,11,NPS,4353,frijol
Michoacán de Ocampo,3598,2562,2013,11,NPS,1036,frijol
Morelos,955,362,2013,11,NPS,593,frijol
Nayarit,260,189,2013,11,NPS,71,frijol
Nuevo León,1984,958,2013,11,NPS,1026,frijol
Oaxaca,35809,20170,2013,11,NPS,15639,frijol
Puebla,58881,48878,2013,11,NPS,10003,frijol
Querétaro de Arteaga,10805,8691,2013,11,NPS,2114,frijol
Quintana Roo,30,22,2013,11,NPS,8,frijol
San Luis Potosí,123849,54381,2013,11,NPS,69468,frijol
Sonora,975,175,2013,11,NPS,800,frijol
Tabasco,80,80,2013,11,NPS,0,frijol
Tamaulipas,2846,110,2013,11,NPS,2736,frijol
Tlaxcala,4849,3998,2013,11,NPS,851,frijol
Veracruz de Ignacio de la Llave,13093,7663,2013,11,NPS,5430,frijol
Zacatecas,649208,353994,2013,11,NPS,295214,frijol
Coahuila de Zaragoza,9864,1955,2013,11,NPS,7909,frijol
Aguascalientes,9436,8144,2014,1,NPS,1292,frijol
Baja California,621,18,2014,1,D2,603,frijol
Campeche,72,72,2014,1,NPS,0,frijol
Coahuila de Zaragoza,4237,4224,2014,1,NPS,13,frijol
Chiapas,74716,73348,2014,1,NPS,1368,frijol
Chihuahua,103078,101544,2014,1,NPS,1534,frijol
Ciudad de México,105,105,2014,1,NPS,0,frijol
Durango,250132,247158,2014,1,NPS,2974,frijol
Guanajuato,81597,75349,2014,1,NPS,6248,frijol
Guerrero,10929,9126,2014,1,NPS,1803,frijol
Hidalgo,23784,23632,2014,1,NPS,152,frijol
Jalisco,14320,14267,2014,1,NPS,53,frijol
Estado de México,9802,9802,2014,1,NPS,0,frijol
Michoacán de Ocampo,3598,3534,2014,1,NPS,64,frijol
Morelos,955,944,2014,1,NPS,11,frijol
Nayarit,260,260,2014,1,NPS,0,frijol
Nuevo León,1984,1820,2014,1,NPS,164,frijol
Oaxaca,35809,33550,2014,1,NPS,2259,frijol
Puebla,58578,57309,2014,1,NPS,1269,frijol
Querétaro de Arteaga,10805,10459,2014,1,NPS,346,frijol
Quintana Roo,30,30,2014,1,NPS,0,frijol
San Luis Potosí,123849,83891,2014,1,NPS,39958,frijol
Sinaloa,527,200,2014,1,NPS,327,frijol
Sonora,975,975,2014,1,D0,0,frijol
Tabasco,80,80,2014,1,NPS,0,frijol
Tamaulipas,2846,1327,2014,1,NPS,1519,frijol
Tlaxcala,4849,4849,2014,1,NPS,0,frijol
Veracruz de Ignacio de la Llave,13101,13101,2014,1,NPS,0,frijol
Yucatán,7,7,2014,1,NPS,0,frijol
Zacatecas,649208,634841,2014,1,NPS,14367,frijol
Coahuila de Zaragoza,9864,9752,2014,1,NPS,112,frijol
Aguascalientes,9436,8144,2014,2,NPS,1292,frijol
Baja California,621,18,2014,2,D2,603,frijol
Campeche,72,72,2014,2,NPS,0,frijol
Coahuila de Zaragoza,4237,4224,2014,2,NPS,13,frijol
Chiapas,74716,74716,2014,2,NPS,0,frijol
Chihuahua,103078,101544,2014,2,NPS,1534,frijol
Ciudad de México,105,105,2014,2,NPS,0,frijol
Durango,250132,247158,2014,2,NPS,2974,frijol
Guanajuato,81597,75349,2014,2,NPS,6248,frijol
Guerrero,10929,9190,2014,2,D0,1739,frijol
Hidalgo,23784,23632,2014,2,NPS,152,frijol
Jalisco,14320,14317,2014,2,NPS,3,frijol
Estado de México,9802,9802,2014,2,NPS,0,frijol
Michoacán de Ocampo,3598,3566,2014,2,NPS,32,frijol
Morelos,955,955,2014,2,NPS,0,frijol
Nayarit,260,260,2014,2,NPS,0,frijol
Nuevo León,1984,1820,2014,2,NPS,164,frijol
Oaxaca,35809,33566,2014,2,NPS,2243,frijol
Puebla,58578,57534,2014,2,NPS,1044,frijol
Querétaro de Arteaga,10805,10717,2014,2,NPS,88,frijol
Quintana Roo,30,30,2014,2,NPS,0,frijol
San Luis Potosí,123849,84318,2014,2,NPS,39531,frijol
Sinaloa,527,527,2014,2,D0,0,frijol
Sonora,975,975,2014,2,D0,0,frijol
Tabasco,80,80,2014,2,NPS,0,frijol
Tamaulipas,2846,1507,2014,2,NPS,1339,frijol
Tlaxcala,4849,4849,2014,2,NPS,0,frijol
Veracruz de Ignacio de la Llave,13101,13101,2014,2,NPS,0,frijol
Yucatán,37,7,2014,2,NPS,30,frijol
Zacatecas,649208,644540,2014,2,NPS,4668,frijol
Coahuila de Zaragoza,9864,9752,2014,2,NPS,112,frijol
Aguascalientes,9436,8144,2014,3,NPS,1292,frijol
Baja California,621,18,2014,3,D0,603,frijol
Campeche,72,72,2014,3,NPS,0,frijol
Coahuila de Zaragoza,4237,4224,2014,3,NPS,13,frijol
Chiapas,74716,74716,2014,3,NPS,0,frijol
Chihuahua,103078,101544,2014,3,NPS,1534,frijol
Ciudad de México,105,105,2014,3,NPS,0,frijol
Durango,250132,247158,2014,3,NPS,2974,frijol
Guanajuato,81597,75349,2014,3,NPS,6248,frijol
Guerrero,10929,9190,2014,3,NPS,1739,frijol
Hidalgo,23784,23632,2014,3,NPS,152,frijol
Jalisco,14320,14317,2014,3,NPS,3,frijol
Estado de México,9802,9802,2014,3,NPS,0,frijol
Michoacán de Ocampo,3598,3566,2014,3,NPS,32,frijol
Morelos,955,955,2014,3,NPS,0,frijol
Nayarit,260,260,2014,3,NPS,0,frijol
Nuevo León,1984,1820,2014,3,NPS,164,frijol
Oaxaca,35809,33566,2014,3,NPS,2243,frijol
Puebla,58578,57534,2014,3,NPS,1044,frijol
Querétaro de Arteaga,10805,10717,2014,3,NPS,88,frijol
Quintana Roo,30,30,2014,3,NPS,0,frijol
San Luis Potosí,123849,84318,2014,3,NPS,39531,frijol
Sinaloa,527,527,2014,3,NPS,0,frijol
Sonora,975,975,2014,3,D0,0,frijol
Tabasco,80,80,2014,3,NPS,0,frijol
Tamaulipas,2846,1507,2014,3,NPS,1339,frijol
Tlaxcala,4849,4849,2014,3,NPS,0,frijol
Veracruz de Ignacio de la Llave,13101,13101,2014,3,NPS,0,frijol
Yucatán,37,7,2014,3,NPS,30,frijol
Zacatecas,649208,644540,2014,3,NPS,4668,frijol
Coahuila de Zaragoza,9864,9752,2014,3,NPS,112,frijol
Veracruz de Ignacio de la Llave,9634,125,2014,6,NPS,9509,frijol
Ciudad de México,104,5,2014,7,NPS,99,frijol
Veracruz de Ignacio de la Llave,11028,125,2014,7,NPS,10903,frijol
Chiapas,62306,10330,2014,8,NPS,51976,frijol
Ciudad de México,104,17,2014,8,NPS,87,frijol
Guerrero,10246,52,2014,8,D0,10194,frijol
Hidalgo,25044,4,2014,8,NPS,25040,frijol
Tabasco,130,66,2014,8,NPS,64,frijol
Veracruz de Ignacio de la Llave,12282,1038,2014,8,NPS,11244,frijol
Coahuila de Zaragoza,3996,8,2014,9,NPS,3988,frijol
Chiapas,74134,24378,2014,9,NPS,49756,frijol
Chihuahua,114082,52,2014,9,NPS,114030,frijol
Ciudad de México,104,33,2014,9,NPS,71,frijol
Guanajuato,73307,1020,2014,9,NPS,72287,frijol
Guerrero,11556,357,2014,9,D0,11199,frijol
Hidalgo,25052,218,2014,9,NPS,24834,frijol
Jalisco,11264,26,2014,9,NPS,11238,frijol
Estado de México,8872,2,2014,9,NPS,8870,frijol
Michoacán de Ocampo,3928,242,2014,9,D0,3686,frijol
Oaxaca,33877,8,2014,9,NPS,33869,frijol
Puebla,58221,4308,2014,9,NPS,53913,frijol
San Luis Potosí,127890,1350,2014,9,NPS,126540,frijol
Tabasco,130,130,2014,9,D0,0,frijol
Veracruz de Ignacio de la Llave,12928,1794,2014,9,NPS,11134,frijol
Aguascalientes,7855,6935,2014,10,NPS,920,frijol
Coahuila de Zaragoza,3996,31,2014,10,NPS,3965,frijol
Chiapas,74134,36332,2014,10,NPS,37802,frijol
Chihuahua,114082,26901,2014,10,NPS,87181,frijol
Ciudad de México,104,36,2014,10,NPS,68,frijol
Durango,251688,73584,2014,10,NPS,178104,frijol
Guanajuato,73307,26782,2014,10,NPS,46525,frijol
Guerrero,11556,3663,2014,10,NPS,7893,frijol
Hidalgo,25052,4752,2014,10,NPS,20300,frijol
Jalisco,11264,456,2014,10,NPS,10808,frijol
Estado de México,8872,2571,2014,10,NPS,6301,frijol
Michoacán de Ocampo,3928,1043,2014,10,D0,2885,frijol
Nayarit,112,24,2014,10,NPS,88,frijol
Oaxaca,33877,709,2014,10,NPS,33168,frijol
Puebla,58221,14618,2014,10,NPS,43603,frijol
San Luis Potosí,127890,74536,2014,10,NPS,53354,frijol
Sonora,558,15,2014,10,NPS,543,frijol
Tabasco,130,130,2014,10,NPS,0,frijol
Veracruz de Ignacio de la Llave,12928,3343,2014,10,NPS,9585,frijol
Zacatecas,573347,59178,2014,10,NPS,514169,frijol
Aguascalientes,7855,7443,2014,11,NPS,412,frijol
Coahuila de Zaragoza,3996,2244,2014,11,NPS,1752,frijol
Chiapas,74134,44638,2014,11,NPS,29496,frijol
Chihuahua,114082,99801,2014,11,NPS,14281,frijol
Ciudad de México,104,55,2014,11,NPS,49,frijol
Durango,251688,168686,2014,11,NPS,83002,frijol
Guanajuato,73307,57717,2014,11,NPS,15590,frijol
Guerrero,11556,7892,2014,11,NPS,3664,frijol
Hidalgo,25052,17133,2014,11,NPS,7919,frijol
Jalisco,11264,5121,2014,11,NPS,6143,frijol
Estado de México,8872,7857,2014,11,NPS,1015,frijol
Michoacán de Ocampo,3928,2296,2014,11,NPS,1632,frijol
Morelos,949,566,2014,11,NPS,383,frijol
Nayarit,112,94,2014,11,NPS,18,frijol
Nuevo León,2401,1359,2014,11,NPS,1042,frijol
Oaxaca,33877,9159,2014,11,NPS,24718,frijol
Puebla,58221,33198,2014,11,NPS,25023,frijol
Querétaro de Arteaga,11061,9015,2014,11,NPS,2046,frijol
Quintana Roo,1,1,2014,11,NPS,0,frijol
San Luis Potosí,127890,104450,2014,11,NPS,23440,frijol
Sonora,558,58,2014,11,NPS,500,frijol
Tabasco,130,130,2014,11,NPS,0,frijol
Tamaulipas,1415,40,2014,11,NPS,1375,frijol
Tlaxcala,4533,3914,2014,11,NPS,619,frijol
Veracruz de Ignacio de la Llave,12928,7303,2014,11,NPS,5625,frijol
Zacatecas,573347,385300,2014,11,NPS,188047,frijol
Coahuila de Zaragoza,11535,1462,2014,11,NPS,10073,frijol
Aguascalientes,7855,7443,2015,1,NPS,412,frijol
Campeche,75,75,2015,1,NPS,0,frijol
Coahuila de Zaragoza,3996,3996,2015,1,NPS,0,frijol
Chiapas,74134,72164,2015,1,NPS,1970,frijol
Chihuahua,114082,112988,2015,1,NPS,1094,frijol
Ciudad de México,104,104,2015,1,NPS,0,frijol
Durango,251688,249450,2015,1,NPS,2238,frijol
Guanajuato,73307,70821,2015,1,NPS,2486,frijol
Guerrero,11556,10529,2015,1,D0,1027,frijol
Hidalgo,25052,25012,2015,1,NPS,40,frijol
Jalisco,11264,10850,2015,1,NPS,414,frijol
Estado de México,8872,8862,2015,1,NPS,10,frijol
Michoacán de Ocampo,3928,3630,2015,1,D0,298,frijol
Morelos,949,949,2015,1,NPS,0,frijol
Nayarit,112,112,2015,1,NPS,0,frijol
Nuevo León,2401,2386,2015,1,NPS,15,frijol
Oaxaca,33877,33394,2015,1,NPS,483,frijol
Puebla,58221,46514,2015,1,NPS,11707,frijol
Querétaro de Arteaga,11061,10111,2015,1,NPS,950,frijol
Quintana Roo,1,1,2015,1,NPS,0,frijol
San Luis Potosí,127890,114282,2015,1,NPS,13608,frijol
Sonora,558,558,2015,1,NPS,0,frijol
Tabasco,130,130,2015,1,NPS,0,frijol
Tamaulipas,1415,939,2015,1,NPS,476,frijol
Tlaxcala,4533,4533,2015,1,NPS,0,frijol
Veracruz de Ignacio de la Llave,12928,8746,2015,1,NPS,4182,frijol
Yucatán,7,5,2015,1,NPS,2,frijol
Zacatecas,573347,517913,2015,1,NPS,55434,frijol
Coahuila de Zaragoza,11535,11481,2015,1,NPS,54,frijol
Aguascalientes,7855,7443,2015,2,NPS,412,frijol
Campeche,75,75,2015,2,NPS,0,frijol
Coahuila de Zaragoza,3996,3996,2015,2,NPS,0,frijol
Chiapas,74134,72164,2015,2,NPS,1970,frijol
Chihuahua,114082,112988,2015,2,NPS,1094,frijol
Ciudad de México,104,104,2015,2,NPS,0,frijol
Durango,251688,249450,2015,2,NPS,2238,frijol
Guanajuato,73307,70821,2015,2,NPS,2486,frijol
Guerrero,11556,11075,2015,2,NPS,481,frijol
Hidalgo,25052,25012,2015,2,NPS,40,frijol
Jalisco,11264,10861,2015,2,NPS,403,frijol
Estado de México,8872,8872,2015,2,NPS,0,frijol
Michoacán de Ocampo,3928,3911,2015,2,D0,17,frijol
Morelos,949,949,2015,2,NPS,0,frijol
Nayarit,112,112,2015,2,NPS,0,frijol
Nuevo León,2401,2386,2015,2,NPS,15,frijol
Oaxaca,33877,33464,2015,2,NPS,413,frijol
Puebla,58221,49078,2015,2,NPS,9143,frijol
Querétaro de Arteaga,11061,10637,2015,2,NPS,424,frijol
Quintana Roo,1,1,2015,2,NPS,0,frijol
San Luis Potosí,127890,114948,2015,2,NPS,12942,frijol
Sonora,558,558,2015,2,NPS,0,frijol
Tabasco,130,130,2015,2,NPS,0,frijol
Tamaulipas,1415,992,2015,2,NPS,423,frijol
Tlaxcala,4533,4533,2015,2,NPS,0,frijol
Veracruz de Ignacio de la Llave,12928,12320,2015,2,NPS,608,frijol
Yucatán,7,7,2015,2,NPS,0,frijol
Zacatecas,573347,517913,2015,2,NPS,55434,frijol
Coahuila de Zaragoza,11535,11481,2015,2,NPS,54,frijol
Aguascalientes,7855,7443,2015,3,NPS,412,frijol
Campeche,75,75,2015,3,NPS,0,frijol
Coahuila de Zaragoza,3996,3996,2015,3,NPS,0,frijol
Chiapas,74134,72164,2015,3,NPS,1970,frijol
Chihuahua,114082,112988,2015,3,NPS,1094,frijol
Ciudad de México,104,104,2015,3,NPS,0,frijol
Durango,251688,249450,2015,3,NPS,2238,frijol
Guanajuato,73307,70821,2015,3,NPS,2486,frijol
Guerrero,11556,11075,2015,3,NPS,481,frijol
Hidalgo,25052,25012,2015,3,NPS,40,frijol
Jalisco,11264,10861,2015,3,NPS,403,frijol
Estado de México,8872,8872,2015,3,NPS,0,frijol
Michoacán de Ocampo,3928,3911,2015,3,NPS,17,frijol
Morelos,949,949,2015,3,NPS,0,frijol
Nayarit,112,112,2015,3,NPS,0,frijol
Nuevo León,2401,2386,2015,3,NPS,15,frijol
Oaxaca,33877,33466,2015,3,NPS,411,frijol
Puebla,58221,49078,2015,3,NPS,9143,frijol
Querétaro de Arteaga,11061,10637,2015,3,NPS,424,frijol
Quintana Roo,1,1,2015,3,NPS,0,frijol
San Luis Potosí,127890,114948,2015,3,NPS,12942,frijol
Sonora,558,558,2015,3,NPS,0,frijol
Tabasco,130,130,2015,3,NPS,0,frijol
Tamaulipas,1415,992,2015,3,NPS,423,frijol
Tlaxcala,4533,4533,2015,3,NPS,0,frijol
Veracruz de Ignacio de la Llave,12928,12928,2015,3,NPS,0,frijol
Yucatán,7,7,2015,3,NPS,0,frijol
Zacatecas,573347,517913,2015,3,NPS,55434,frijol
Coahuila de Zaragoza,11535,11481,2015,3,NPS,54,frijol
Puebla,38012,118,2015,6,NPS,37894,frijol
Ciudad de México,107,14,2015,7,NPS,93,frijol
Durango,101609,84,2015,7,NPS,101525,frijol
Puebla,44516,118,2015,7,NPS,44398,frijol
Veracruz de Ignacio de la Llave,4915,125,2015,7,NPS,4790,frijol
Coahuila de Zaragoza,2531,84,2015,7,NPS,2447,frijol
Chiapas,62017,10584,2015,8,D1,51433,frijol
Ciudad de México,107,28,2015,8,NPS,79,frijol
Durango,244061,84,2015,8,NPS,243977,frijol
Estado de México,6775,150,2015,8,NPS,6625,frijol
Puebla,45024,154,2015,8,NPS,44870,frijol
San Luis Potosí,113748,150,2015,8,NPS,113598,frijol
Tabasco,75,45,2015,8,D1,30,frijol
Veracruz de Ignacio de la Llave,11769,352,2015,8,D0,11417,frijol
Coahuila de Zaragoza,8015,84,2015,8,NPS,7931,frijol
Chiapas,73098,29226,2015,9,D1,43872,frijol
Ciudad de México,107,32,2015,9,NPS,75,frijol
Durango,250477,85,2015,9,NPS,250392,frijol
Guanajuato,76366,25,2015,9,NPS,76341,frijol
Guerrero,12426,250,2015,9,D0,12176,frijol
Hidalgo,25753,1134,2015,9,NPS,24619,frijol
Estado de México,6823,458,2015,9,NPS,6365,frijol
Nuevo León,1648,6,2015,9,NPS,1642,frijol
Oaxaca,32330,6,2015,9,NPS,32324,frijol
Puebla,55782,1360,2015,9,NPS,54422,frijol
Querétaro de Arteaga,10769,140,2015,9,NPS,10629,frijol
San Luis Potosí,113748,1761,2015,9,NPS,111987,frijol
Tabasco,75,53,2015,9,D1,22,frijol
Veracruz de Ignacio de la Llave,13224,800,2015,9,D0,12424,frijol
Coahuila de Zaragoza,10975,85,2015,9,NPS,10890,frijol
Aguascalientes,8200,5996,2015,10,NPS,2204,frijol
Coahuila de Zaragoza,3428,81,2015,10,NPS,3347,frijol
Chiapas,73548,40635,2015,10,D0,32913,frijol
Chihuahua,120724,8030,2015,10,NPS,112694,frijol
Ciudad de México,107,36,2015,10,NPS,71,frijol
Durango,250477,3079,2015,10,NPS,247398,frijol
Guanajuato,76366,17790,2015,10,NPS,58576,frijol
Guerrero,12426,2474,2015,10,D0,9952,frijol
Hidalgo,25753,5488,2015,10,NPS,20265,frijol
Jalisco,10299,291,2015,10,NPS,10008,frijol
Estado de México,6823,4188,2015,10,NPS,2635,frijol
Michoacán de Ocampo,3912,812,2015,10,D0,3100,frijol
Nuevo León,1648,1066,2015,10,NPS,582,frijol
Oaxaca,32330,639,2015,10,NPS,31691,frijol
Puebla,55782,7323,2015,10,NPS,48459,frijol
Querétaro de Arteaga,10769,6867,2015,10,D0,3902,frijol
Quintana Roo,52,18,2015,10,NPS,34,frijol
San Luis Potosí,113748,14837,2015,10,NPS,98911,frijol
Sonora,668,60,2015,10,NPS,608,frijol
Tabasco,75,73,2015,10,D1,2,frijol
Tlaxcala,3516,1951,2015,10,NPS,1565,frijol
Veracruz de Ignacio de la Llave,13224,5456,2015,10,D0,7768,frijol
Zacatecas,559895,45453,2015,10,NPS,514442,frijol
Coahuila de Zaragoza,10975,1352,2015,10,NPS,9623,frijol
Aguascalientes,8200,7019,2015,11,NPS,1181,frijol
Coahuila de Zaragoza,3428,2261,2015,11,NPS,1167,frijol
Chiapas,73548,48436,2015,11,NPS,25112,frijol
Chihuahua,120724,81518,2015,11,NPS,39206,frijol
Ciudad de México,107,62,2015,11,NPS,45,frijol
Durango,250477,119081,2015,11,NPS,131396,frijol
Guanajuato,76366,51744,2015,11,NPS,24622,frijol
Guerrero,12426,6765,2015,11,D0,5661,frijol
Hidalgo,25753,18667,2015,11,NPS,7086,frijol
Jalisco,10299,1095,2015,11,NPS,9204,frijol
Estado de México,6823,5694,2015,11,NPS,1129,frijol
Michoacán de Ocampo,3912,2034,2015,11,D0,1878,frijol
Morelos,936,599,2015,11,NPS,337,frijol
Nayarit,108,80,2015,11,NPS,28,frijol
Nuevo León,1648,1258,2015,11,NPS,390,frijol
Oaxaca,32330,8806,2015,11,NPS,23524,frijol
Puebla,55782,33883,2015,11,NPS,21899,frijol
Querétaro de Arteaga,10769,8676,2015,11,NPS,2093,frijol
Quintana Roo,52,38,2015,11,NPS,14,frijol
San Luis Potosí,113748,65886,2015,11,NPS,47862,frijol
Sonora,668,118,2015,11,NPS,550,frijol
Tabasco,75,73,2015,11,D1,2,frijol
Tamaulipas,4627,30,2015,11,NPS,4597,frijol
Tlaxcala,3516,3306,2015,11,NPS,210,frijol
Veracruz de Ignacio de la Llave,13224,8551,2015,11,NPS,4673,frijol
Zacatecas,559895,398621,2015,11,NPS,161274,frijol
Coahuila de Zaragoza,10975,9532,2015,11,NPS,1443,frijol
Aguascalientes,8200,7031,2016,1,NPS,1169,frijol
Coahuila de Zaragoza,3428,3141,2016,1,NPS,287,frijol
Chiapas,73548,70619,2016,1,NPS,2929,frijol
Chihuahua,120724,103555,2016,1,NPS,17169,frijol
Ciudad de México,107,107,2016,1,D0,0,frijol
Durango,250477,244677,2016,1,D0,5800,frijol
Guanajuato,76366,69520,2016,1,NPS,6846,frijol
Guerrero,12426,12058,2016,1,NPS,368,frijol
Hidalgo,25753,21586,2016,1,NPS,4167,frijol
Jalisco,10299,10257,2016,1,NPS,42,frijol
Estado de México,6823,6823,2016,1,NPS,0,frijol
Michoacán de Ocampo,3912,3876,2016,1,NPS,36,frijol
Morelos,936,936,2016,1,NPS,0,frijol
Nayarit,108,80,2016,1,NPS,28,frijol
Nuevo León,1648,1496,2016,1,D0,152,frijol
Oaxaca,32330,32081,2016,1,NPS,249,frijol
Puebla,55782,44655,2016,1,NPS,11127,frijol
Querétaro de Arteaga,10769,10689,2016,1,D0,80,frijol
Quintana Roo,52,52,2016,1,NPS,0,frijol
San Luis Potosí,113748,71918,2016,1,NPS,41830,frijol
Sonora,668,668,2016,1,NPS,0,frijol
Tabasco,75,73,2016,1,NPS,2,frijol
Tamaulipas,4627,3937,2016,1,NPS,690,frijol
Tlaxcala,3516,3516,2016,1,NPS,0,frijol
Veracruz de Ignacio de la Llave,13224,12922,2016,1,NPS,302,frijol
Yucatán,7,3,2016,1,NPS,4,frijol
Zacatecas,559895,547106,2016,1,NPS,12789,frijol
Coahuila de Zaragoza,10975,9532,2016,1,NPS,1443,frijol
Aguascalientes,8200,7031,2016,2,NPS,1169,frijol
Coahuila de Zaragoza,3428,3141,2016,2,NPS,287,frijol
Chiapas,73548,70619,2016,2,NPS,2929,frijol
Chihuahua,120724,103555,2016,2,NPS,17169,frijol
Ciudad de México,107,107,2016,2,D0,0,frijol
Durango,250477,248248,2016,2,D0,2229,frijol
Guanajuato,76366,69520,2016,2,NPS,6846,frijol
Guerrero,12426,12273,2016,2,D1,153,frijol
Hidalgo,25753,21586,2016,2,NPS,4167,frijol
Jalisco,10299,10257,2016,2,NPS,42,frijol
Estado de México,6823,6823,2016,2,NPS,0,frijol
Michoacán de Ocampo,3912,3912,2016,2,D0,0,frijol
Morelos,936,936,2016,2,NPS,0,frijol
Nayarit,108,80,2016,2,NPS,28,frijol
Nuevo León,1648,1648,2016,2,D1,0,frijol
Oaxaca,32330,32081,2016,2,NPS,249,frijol
Puebla,55782,44903,2016,2,NPS,10879,frijol
Querétaro de Arteaga,10769,10689,2016,2,NPS,80,frijol
Quintana Roo,52,52,2016,2,NPS,0,frijol
San Luis Potosí,113748,71918,2016,2,NPS,41830,frijol
Sonora,668,668,2016,2,D0,0,frijol
Tabasco,75,73,2016,2,NPS,2,frijol
Tamaulipas,4627,4460,2016,2,NPS,167,frijol
Tlaxcala,3516,3516,2016,2,NPS,0,frijol
Veracruz de Ignacio de la Llave,13224,13022,2016,2,D0,202,frijol
Yucatán,7,7,2016,2,D0,0,frijol
Zacatecas,559895,547106,2016,2,NPS,12789,frijol
Coahuila de Zaragoza,10975,9532,2016,2,NPS,1443,frijol
Aguascalientes,8200,7031,2016,3,NPS,1169,frijol
Coahuila de Zaragoza,3428,3141,2016,3,NPS,287,frijol
Chiapas,73548,70619,2016,3,NPS,2929,frijol
Chihuahua,120724,103555,2016,3,D0,17169,frijol
Ciudad de México,107,107,2016,3,D0,0,frijol
Durango,250477,248248,2016,3,D0,2229,frijol
Guanajuato,76366,69520,2016,3,NPS,6846,frijol
Guerrero,12426,12273,2016,3,D1,153,frijol
Hidalgo,25753,21586,2016,3,D0,4167,frijol
Jalisco,10299,10257,2016,3,NPS,42,frijol
Estado de México,6823,6823,2016,3,NPS,0,frijol
Michoacán de Ocampo,3912,3912,2016,3,D0,0,frijol
Morelos,936,936,2016,3,NPS,0,frijol
Nayarit,108,80,2016,3,NPS,28,frijol
Nuevo León,1648,1648,2016,3,D0,0,frijol
Oaxaca,32330,32081,2016,3,NPS,249,frijol
Puebla,55782,44903,2016,3,NPS,10879,frijol
Querétaro de Arteaga,10769,10689,2016,3,NPS,80,frijol
Quintana Roo,52,52,2016,3,NPS,0,frijol
San Luis Potosí,113748,71918,2016,3,NPS,41830,frijol
Sonora,668,668,2016,3,D0,0,frijol
Tabasco,75,73,2016,3,NPS,2,frijol
Tamaulipas,4627,4460,2016,3,NPS,167,frijol
Tlaxcala,3516,3516,2016,3,NPS,0,frijol
Veracruz de Ignacio de la Llave,13224,13108,2016,3,D0,116,frijol
Yucatán,7,7,2016,3,D0,0,frijol
Zacatecas,559895,547106,2016,3,NPS,12789,frijol
Coahuila de Zaragoza,10975,9532,2016,3,NPS,1443,frijol
Puebla,41999,84,2016,6,NPS,41915,frijol
Veracruz de Ignacio de la Llave,9764,129,2016,6,D1,9635,frijol
Puebla,47540,84,2016,7,NPS,47456,frijol
Veracruz de Ignacio de la Llave,10228,129,2016,7,D0,10099,frijol
Chiapas,64028,4610,2016,8,D0,59418,frijol
Ciudad de México,87,12,2016,8,NPS,75,frijol
Hidalgo,18708,468,2016,8,NPS,18240,frijol
Estado de México,4478,2,2016,8,NPS,4476,frijol
Puebla,48655,102,2016,8,NPS,48553,frijol
Veracruz de Ignacio de la Llave,11490,129,2016,8,NPS,11361,frijol
Chiapas,73276,29270,2016,9,NPS,44006,frijol
Ciudad de México,87,14,2016,9,NPS,73,frijol
Guanajuato,67327,287,2016,9,NPS,67040,frijol
Guerrero,12921,87,2016,9,NPS,12834,frijol
Hidalgo,18713,907,2016,9,NPS,17806,frijol
Estado de México,4478,696,2016,9,NPS,3782,frijol
Oaxaca,31314,9,2016,9,D0,31305,frijol
Puebla,48815,3022,2016,9,NPS,45793,frijol
Querétaro de Arteaga,7972,564,2016,9,NPS,7408,frijol
Veracruz de Ignacio de la Llave,11607,1095,2016,9,NPS,10512,frijol
Aguascalientes,9007,3017,2016,10,NPS,5990,frijol
Coahuila de Zaragoza,3016,1,2016,10,NPS,3015,frijol
Chiapas,73276,47726,2016,10,D1,25550,frijol
Chihuahua,113491,21689,2016,10,NPS,91802,frijol
Ciudad de México,87,22,2016,10,NPS,65,frijol
Durango,242442,14350,2016,10,NPS,228092,frijol
Guanajuato,67327,24254,2016,10,NPS,43073,frijol
Guerrero,12962,2087,2016,10,D1,10875,frijol
Hidalgo,18713,2922,2016,10,NPS,15791,frijol
Jalisco,6349,275,2016,10,NPS,6074,frijol
Estado de México,4478,2034,2016,10,NPS,2444,frijol
Michoacán de Ocampo,3340,216,2016,10,D0,3124,frijol
Nuevo León,1488,90,2016,10,NPS,1398,frijol
Oaxaca,31314,704,2016,10,NPS,30610,frijol
Puebla,48815,10851,2016,10,NPS,37964,frijol
Querétaro de Arteaga,7972,5576,2016,10,NPS,2396,frijol
San Luis Potosí,95425,2655,2016,10,D0,92770,frijol
Sonora,721,52,2016,10,NPS,669,frijol
Tamaulipas,2374,270,2016,10,NPS,2104,frijol
Tlaxcala,2931,1782,2016,10,NPS,1149,frijol
Veracruz de Ignacio de la Llave,11687,3661,2016,10,NPS,8026,frijol
Zacatecas,587605,36497,2016,10,NPS,551108,frijol
Aguascalientes,9007,8272,2016,11,NPS,735,frijol
Campeche,131,62,2016,11,D1,69,frijol
Coahuila de Zaragoza,3016,1999,2016,11,NPS,1017,frijol
Chiapas,73276,54076,2016,11,NPS,19200,frijol
Chihuahua,113491,100367,2016,11,NPS,13124,frijol
Ciudad de México,87,69,2016,11,NPS,18,frijol
Durango,242442,161818,2016,11,NPS,80624,frijol
Guanajuato,67327,48532,2016,11,NPS,18795,frijol
Guerrero,12962,8000,2016,11,D1,4962,frijol
Hidalgo,18713,12966,2016,11,NPS,5747,frijol
Jalisco,6349,3859,2016,11,NPS,2490,frijol
Estado de México,4478,2910,2016,11,NPS,1568,frijol
Michoacán de Ocampo,3340,2030,2016,11,NPS,1310,frijol
Morelos,842,536,2016,11,NPS,306,frijol
Nayarit,72,72,2016,11,NPS,0,frijol
Nuevo León,1488,201,2016,11,NPS,1287,frijol
Oaxaca,31314,8807,2016,11,NPS,22507,frijol
Puebla,48815,37729,2016,11,NPS,11086,frijol
Querétaro de Arteaga,7972,7864,2016,11,NPS,108,frijol
Quintana Roo,52,14,2016,11,D1,38,frijol
San Luis Potosí,95425,46160,2016,11,NPS,49265,frijol
Sonora,721,87,2016,11,NPS,634,frijol
Tamaulipas,2374,280,2016,11,NPS,2094,frijol
Tlaxcala,2931,2931,2016,11,NPS,0,frijol
Veracruz de Ignacio de la Llave,11687,6428,2016,11,NPS,5259,frijol
Yucatán,7,7,2016,11,D1,0,frijol
Zacatecas,587605,457297,2016,11,NPS,130308,frijol
Coahuila de Zaragoza,9268,9108,2016,11,NPS,160,frijol
Aguascalientes,9007,8387,2017,1,NPS,620,frijol
Campeche,131,131,2017,1,D0,0,frijol
Coahuila de Zaragoza,3016,3016,2017,1,NPS,0,frijol
Chiapas,73276,73276,2017,1,NPS,0,frijol
Chihuahua,113491,113491,2017,1,NPS,0,frijol
Ciudad de México,87,87,2017,1,NPS,0,frijol
Durango,242442,239127,2017,1,NPS,3315,frijol
Guanajuato,67327,65829,2017,1,NPS,1498,frijol
Guerrero,12962,12910,2017,1,D1,52,frijol
Hidalgo,18713,18566,2017,1,NPS,147,frijol
Jalisco,6349,6349,2017,1,NPS,0,frijol
Estado de México,4478,4110,2017,1,NPS,368,frijol
Michoacán de Ocampo,3340,3320,2017,1,NPS,20,frijol
Morelos,842,842,2017,1,NPS,0,frijol
Nayarit,72,72,2017,1,NPS,0,frijol
Nuevo León,1488,1170,2017,1,NPS,318,frijol
Oaxaca,31314,31245,2017,1,D0,69,frijol
Puebla,48815,47475,2017,1,NPS,1340,frijol
Querétaro de Arteaga,7972,7972,2017,1,D0,0,frijol
Quintana Roo,52,52,2017,1,D1,0,frijol
San Luis Potosí,95425,53847,2017,1,NPS,41578,frijol
Sonora,721,703,2017,1,D0,18,frijol
Tamaulipas,2374,2284,2017,1,NPS,90,frijol
Tlaxcala,2931,2931,2017,1,NPS,0,frijol
Veracruz de Ignacio de la Llave,11687,9816,2017,1,NPS,1871,frijol
Yucatán,7,7,2017,1,NPS,0,frijol
Zacatecas,587605,585270,2017,1,NPS,2335,frijol
Coahuila de Zaragoza,9268,9220,2017,1,NPS,48,frijol
Aguascalientes,9007,8387,2017,2,D0,620,frijol
Campeche,131,131,2017,2,D0,0,frijol
Coahuila de Zaragoza,3016,3016,2017,2,NPS,0,frijol
Chiapas,73276,73276,2017,2,NPS,0,frijol
Chihuahua,113491,113491,2017,2,NPS,0,frijol
Ciudad de México,87,87,2017,2,NPS,0,frijol
Durango,242442,239127,2017,2,NPS,3315,frijol
Guanajuato,67327,65911,2017,2,D0,1416,frijol
Guerrero,12962,12962,2017,2,D1,0,frijol
Hidalgo,18713,18566,2017,2,NPS,147,frijol
Jalisco,6349,6349,2017,2,D0,0,frijol
Estado de México,4478,4478,2017,2,NPS,0,frijol
Michoacán de Ocampo,3340,3340,2017,2,D0,0,frijol
Morelos,842,842,2017,2,D0,0,frijol
Nayarit,72,72,2017,2,NPS,0,frijol
Nuevo León,1488,1170,2017,2,NPS,318,frijol
Oaxaca,31314,31245,2017,2,D0,69,frijol
Puebla,48815,48815,2017,2,NPS,0,frijol
Querétaro de Arteaga,7972,7972,2017,2,D0,0,frijol
Quintana Roo,52,52,2017,2,NPS,0,frijol
San Luis Potosí,95425,53847,2017,2,D0,41578,frijol
Sonora,721,703,2017,2,D0,18,frijol
Tamaulipas,2374,2284,2017,2,D0,90,frijol
Tlaxcala,2931,2931,2017,2,NPS,0,frijol
Veracruz de Ignacio de la Llave,11687,11687,2017,2,NPS,0,frijol
Yucatán,7,7,2017,2,NPS,0,frijol
Zacatecas,587605,585270,2017,2,D0,2335,frijol
Coahuila de Zaragoza,9268,9220,2017,2,NPS,48,frijol
Veracruz de Ignacio de la Llave,8773,64,2017,6,D0,8709,frijol
Puebla,40781,103,2017,7,NPS,40678,frijol
Veracruz de Ignacio de la Llave,10640,126,2017,7,D0,10514,frijol
Aguascalientes,7386,2114,2017,8,D0,5272,frijol
Chiapas,63246,5046,2017,8,D0,58200,frijol
Ciudad de México,85,2,2017,8,NPS,83,frijol
Hidalgo,18556,460,2017,8,NPS,18096,frijol
Estado de México,4444,92,2017,8,NPS,4352,frijol
Nuevo León,1395,3,2017,8,D0,1392,frijol
Puebla,41396,103,2017,8,NPS,41293,frijol
Veracruz de Ignacio de la Llave,11140,244,2017,8,NPS,10896,frijol
Zacatecas,614493,27841,2017,8,D0,586652,frijol
Aguascalientes,7386,2114,2017,9,NPS,5272,frijol
Coahuila de Zaragoza,2424,36,2017,9,D0,2388,frijol
Chiapas,71424,32602,2017,9,D0,38822,frijol
Ciudad de México,85,2,2017,9,NPS,83,frijol
Guerrero,11957,49,2017,9,NPS,11908,frijol
Hidalgo,19484,674,2017,9,NPS,18810,frijol
Estado de México,4471,677,2017,9,NPS,3794,frijol
Nuevo León,1639,3,2017,9,D0,1636,frijol
Oaxaca,33420,7,2017,9,NPS,33413,frijol
Puebla,42406,4124,2017,9,NPS,38282,frijol
Quintana Roo,52,11,2017,9,NPS,41,frijol
San Luis Potosí,108396,525,2017,9,D0,107871,frijol
Tlaxcala,2309,88,2017,9,NPS,2221,frijol
Veracruz de Ignacio de la Llave,12348,868,2017,9,NPS,11480,frijol
Zacatecas,614953,27841,2017,9,NPS,587112,frijol
Aguascalientes,7386,2679,2017,10,NPS,4707,frijol
Coahuila de Zaragoza,2424,36,2017,10,NPS,2388,frijol
Chiapas,71426,48623,2017,10,D0,22803,frijol
Chihuahua,103819,40911,2017,10,NPS,62908,frijol
Ciudad de México,85,4,2017,10,NPS,81,frijol
Durango,242647,10166,2017,10,NPS,232481,frijol
Guanajuato,59286,19659,2017,10,NPS,39627,frijol
Guerrero,11957,2010,2017,10,NPS,9947,frijol
Hidalgo,19484,2368,2017,10,NPS,17116,frijol
Jalisco,9208,407,2017,10,NPS,8801,frijol
Estado de México,4471,2097,2017,10,NPS,2374,frijol
Michoacán de Ocampo,2837,482,2017,10,NPS,2355,frijol
Morelos,729,15,2017,10,NPS,714,frijol
Nayarit,160,115,2017,10,NPS,45,frijol
Nuevo León,1639,33,2017,10,NPS,1606,frijol
Oaxaca,33420,652,2017,10,NPS,32768,frijol
Puebla,42406,11378,2017,10,NPS,31028,frijol
Querétaro de Arteaga,7889,2640,2017,10,NPS,5249,frijol
Quintana Roo,52,13,2017,10,NPS,39,frijol
San Luis Potosí,108396,5004,2017,10,NPS,103392,frijol
Sonora,853,64,2017,10,D0,789,frijol
Tlaxcala,2309,1074,2017,10,NPS,1235,frijol
Veracruz de Ignacio de la Llave,12348,3193,2017,10,NPS,9155,frijol
Zacatecas,614953,43973,2017,10,NPS,570980,frijol
Aguascalientes,7386,7386,2017,11,NPS,0,frijol
Campeche,55,55,2017,11,NPS,0,frijol
Coahuila de Zaragoza,2424,152,2017,11,NPS,2272,frijol
Chiapas,71426,52374,2017,11,D0,19052,frijol
Chihuahua,103819,98020,2017,11,NPS,5799,frijol
Ciudad de México,85,55,2017,11,NPS,30,frijol
Durango,242647,138552,2017,11,NPS,104095,frijol
Guanajuato,59286,46995,2017,11,NPS,12291,frijol
Guerrero,11957,8174,2017,11,NPS,3783,frijol
Hidalgo,19484,7661,2017,11,NPS,11823,frijol
Jalisco,9208,5724,2017,11,NPS,3484,frijol
Estado de México,4471,3546,2017,11,NPS,925,frijol
Michoacán de Ocampo,2837,1280,2017,11,D0,1557,frijol
Morelos,729,514,2017,11,NPS,215,frijol
Nayarit,160,135,2017,11,D0,25,frijol
Nuevo León,1639,127,2017,11,NPS,1512,frijol
Oaxaca,33420,8648,2017,11,NPS,24772,frijol
Puebla,42406,35426,2017,11,NPS,6980,frijol
Querétaro de Arteaga,7889,4481,2017,11,NPS,3408,frijol
Quintana Roo,52,33,2017,11,NPS,19,frijol
San Luis Potosí,108396,62637,2017,11,D0,45759,frijol
Sinaloa,705,5,2017,11,D1,700,frijol
Sonora,853,119,2017,11,D1,734,frijol
Tlaxcala,2309,1937,2017,11,NPS,372,frijol
Veracruz de Ignacio de la Llave,12348,6342,2017,11,NPS,6006,frijol
Zacatecas,614953,434174,2017,11,NPS,180779,frijol
Aguascalientes,7386,7386,2018,1,NPS,0,frijol
Campeche,55,55,2018,1,NPS,0,frijol
Coahuila de Zaragoza,2424,1942,2018,1,NPS,482,frijol
Chiapas,71426,71426,2018,1,D0,0,frijol
Chihuahua,103819,103807,2018,1,NPS,12,frijol
Ciudad de México,85,85,2018,1,D0,0,frijol
Durango,242647,240542,2018,1,NPS,2105,frijol
Guanajuato,59286,58111,2018,1,D1,1175,frijol
Guerrero,11957,11916,2018,1,D0,41,frijol
Hidalgo,19484,16735,2018,1,NPS,2749,frijol
Jalisco,9208,8930,2018,1,D0,278,frijol
Estado de México,4471,4471,2018,1,D0,0,frijol
Michoacán de Ocampo,2837,2807,2018,1,D0,30,frijol
Morelos,729,720,2018,1,D0,9,frijol
Nayarit,160,160,2018,1,D0,0,frijol
Nuevo León,1639,1459,2018,1,NPS,180,frijol
Oaxaca,33420,30719,2018,1,NPS,2701,frijol
Puebla,42406,41406,2018,1,NPS,1000,frijol
Querétaro de Arteaga,7889,6827,2018,1,D1,1062,frijol
Quintana Roo,52,52,2018,1,NPS,0,frijol
San Luis Potosí,108396,74262,2018,1,NPS,34134,frijol
Sinaloa,705,155,2018,1,D1,550,frijol
Sonora,853,853,2018,1,D2,0,frijol
Tamaulipas,1157,652,2018,1,NPS,505,frijol
Tlaxcala,2309,2309,2018,1,D0,0,frijol
Veracruz de Ignacio de la Llave,12348,12091,2018,1,NPS,257,frijol
Yucatán,6,6,2018,1,NPS,0,frijol
Zacatecas,614953,611900,2018,1,NPS,3053,frijol
Aguascalientes,7386,7386,2018,2,NPS,0,frijol
Campeche,55,55,2018,2,NPS,0,frijol
Coahuila de Zaragoza,2424,1942,2018,2,NPS,482,frijol
Chiapas,71426,71426,2018,2,NPS,0,frijol
Chihuahua,103819,103807,2018,2,D0,12,frijol
Ciudad de México,85,85,2018,2,NPS,0,frijol
Durango,242647,240542,2018,2,NPS,2105,frijol
Guanajuato,59286,58111,2018,2,D2,1175,frijol
Guerrero,11957,11957,2018,2,D0,0,frijol
Hidalgo,19484,16735,2018,2,NPS,2749,frijol
Jalisco,9208,9202,2018,2,D0,6,frijol
Estado de México,4471,4471,2018,2,D0,0,frijol
Michoacán de Ocampo,2837,2837,2018,2,D1,0,frijol
Morelos,729,720,2018,2,D0,9,frijol
Nayarit,160,160,2018,2,D0,0,frijol
Nuevo León,1639,1459,2018,2,NPS,180,frijol
Oaxaca,33420,30719,2018,2,NPS,2701,frijol
Puebla,42406,42396,2018,2,NPS,10,frijol
Querétaro de Arteaga,7889,7889,2018,2,D1,0,frijol
Quintana Roo,52,52,2018,2,NPS,0,frijol
San Luis Potosí,108396,74752,2018,2,D0,33644,frijol
Sinaloa,705,155,2018,2,D1,550,frijol
Sonora,853,853,2018,2,D2,0,frijol
Tamaulipas,1157,792,2018,2,NPS,365,frijol
Tlaxcala,2309,2309,2018,2,D0,0,frijol
Veracruz de Ignacio de la Llave,12348,12348,2018,2,NPS,0,frijol
Yucatán,6,6,2018,2,NPS,0,frijol
Zacatecas,614953,611902,2018,2,NPS,3051,frijol
Veracruz de Ignacio de la Llave,11016,62,2018,6,NPS,10954,frijol
Hidalgo,14099,107,2018,7,D0,13992,frijol
Puebla,37830,99,2018,7,NPS,37731,frijol
Veracruz de Ignacio de la Llave,11474,450,2018,7,D0,11024,frijol
Chiapas,61886,6247,2018,8,D1,55639,frijol
Ciudad de México,75,3,2018,8,NPS,72,frijol
Hidalgo,15268,224,2018,8,D0,15044,frijol
Estado de México,2921,95,2018,8,NPS,2826,frijol
Puebla,38265,99,2018,8,D0,38166,frijol
Veracruz de Ignacio de la Llave,11840,990,2018,8,D1,10850,frijol
Chiapas,67546,31380,2018,9,D0,36166,frijol
Ciudad de México,75,3,2018,9,NPS,72,frijol
Guanajuato,62660,423,2018,9,NPS,62237,frijol
Guerrero,11972,42,2018,9,D1,11930,frijol
Hidalgo,15268,717,2018,9,D0,14551,frijol
Estado de México,2921,859,2018,9,NPS,2062,frijol
Puebla,39639,1521,2018,9,D0,38118,frijol
Quintana Roo,52,12,2018,9,D0,40,frijol
Tlaxcala,2198,235,2018,9,NPS,1963,frijol
Veracruz de Ignacio de la Llave,12192,1905,2018,9,D1,10287,frijol
Aguascalientes,7391,2797,2018,10,NPS,4594,frijol
Coahuila de Zaragoza,2512,25,2018,10,NPS,2487,frijol
Chiapas,70071,47458,2018,10,D0,22613,frijol
Chihuahua,87564,10317,2018,10,NPS,77247,frijol
Ciudad de México,75,3,2018,10,NPS,72,frijol
Guanajuato,62660,14730,2018,10,NPS,47930,frijol
Guerrero,11972,1778,2018,10,D1,10194,frijol
Hidalgo,15268,1938,2018,10,D1,13330,frijol
Jalisco,8628,598,2018,10,NPS,8030,frijol
Estado de México,2921,1532,2018,10,NPS,1389,frijol
Michoacán de Ocampo,2844,537,2018,10,NPS,2307,frijol
Oaxaca,28769,1383,2018,10,NPS,27386,frijol
Puebla,42539,12332,2018,10,NPS,30207,frijol
Quintana Roo,52,15,2018,10,D0,37,frijol
San Luis Potosí,111914,20340,2018,10,NPS,91574,frijol
Sonora,626,65,2018,10,NPS,561,frijol
Tlaxcala,2198,1502,2018,10,NPS,696,frijol
Veracruz de Ignacio de la Llave,12192,2939,2018,10,D1,9253,frijol
Zacatecas,636256,21025,2018,10,NPS,615231,frijol
Aguascalientes,7391,7387,2018,11,NPS,4,frijol
Campeche,105,25,2018,11,D1,80,frijol
Coahuila de Zaragoza,2512,1165,2018,11,NPS,1347,frijol
Chiapas,70071,53047,2018,11,D0,17024,frijol
Chihuahua,87564,79408,2018,11,NPS,8156,frijol
Ciudad de México,75,50,2018,11,NPS,25,frijol
Durango,216368,102120,2018,11,NPS,114248,frijol
Guanajuato,62660,44225,2018,11,NPS,18435,frijol
Guerrero,11972,8135,2018,11,D0,3837,frijol
Hidalgo,15268,13646,2018,11,D1,1622,frijol
Jalisco,8628,5446,2018,11,NPS,3182,frijol
Estado de México,2921,1997,2018,11,NPS,924,frijol
Michoacán de Ocampo,2844,1408,2018,11,NPS,1436,frijol
Morelos,640,492,2018,11,NPS,148,frijol
Nayarit,181,44,2018,11,NPS,137,frijol
Nuevo León,1061,131,2018,11,NPS,930,frijol
Oaxaca,28769,8878,2018,11,NPS,19891,frijol
Puebla,42539,32665,2018,11,NPS,9874,frijol
Querétaro de Arteaga,7324,1203,2018,11,D1,6121,frijol
Quintana Roo,52,37,2018,11,D1,15,frijol
San Luis Potosí,111914,59625,2018,11,NPS,52289,frijol
Sinaloa,200,150,2018,11,NPS,50,frijol
Sonora,626,103,2018,11,NPS,523,frijol
Tlaxcala,2198,2198,2018,11,NPS,0,frijol
Veracruz de Ignacio de la Llave,12192,5249,2018,11,NPS,6943,frijol
Zacatecas,636256,353726,2018,11,NPS,282530,frijol
Aguascalientes,7391,7387,2019,1,NPS,4,frijol
Campeche,105,105,2019,1,D0,0,frijol
Coahuila de Zaragoza,2512,2507,2019,1,NPS,5,frijol
Chiapas,70071,66195,2019,1,D0,3876,frijol
Chihuahua,87564,87530,2019,1,NPS,34,frijol
Ciudad de México,75,75,2019,1,NPS,0,frijol
Durango,216368,192837,2019,1,NPS,23531,frijol
Guanajuato,62660,62660,2019,1,NPS,0,frijol
Guerrero,11972,11972,2019,1,NPS,0,frijol
Hidalgo,15268,13646,2019,1,D1,1622,frijol
Jalisco,8628,8403,2019,1,NPS,225,frijol
Estado de México,2921,2416,2019,1,NPS,505,frijol
Michoacán de Ocampo,2844,2748,2019,1,NPS,96,frijol
Morelos,640,616,2019,1,NPS,24,frijol
Nayarit,181,181,2019,1,NPS,0,frijol
Nuevo León,1061,471,2019,1,NPS,590,frijol
Oaxaca,28769,27279,2019,1,NPS,1490,frijol
Puebla,42539,40684,2019,1,NPS,1855,frijol
Querétaro de Arteaga,7324,7298,2019,1,NPS,26,frijol
Quintana Roo,52,45,2019,1,NPS,7,frijol
San Luis Potosí,111914,63449,2019,1,D0,48465,frijol
Sinaloa,200,150,2019,1,D0,50,frijol
Sonora,626,398,2019,1,NPS,228,frijol
Tamaulipas,1206,717,2019,1,D0,489,frijol
Tlaxcala,2198,2198,2019,1,NPS,0,frijol
Veracruz de Ignacio de la Llave,12192,11402,2019,1,NPS,790,frijol
Yucatán,6,6,2019,1,D1,0,frijol
Zacatecas,636256,616209,2019,1,NPS,20047,frijol
Aguascalientes,7391,7391,2019,2,NPS,0,frijol
Campeche,105,105,2019,2,D1,0,frijol
Coahuila de Zaragoza,2512,2507,2019,2,NPS,5,frijol
Chiapas,70071,69792,2019,2,D0,279,frijol
Chihuahua,87564,87530,2019,2,NPS,34,frijol
Ciudad de México,75,75,2019,2,NPS,0,frijol
Durango,216368,194843,2019,2,D0,21525,frijol
Guanajuato,62660,62660,2019,2,NPS,0,frijol
Guerrero,11972,11972,2019,2,NPS,0,frijol
Hidalgo,15268,13646,2019,2,D1,1622,frijol
Jalisco,8628,8628,2019,2,NPS,0,frijol
Estado de México,2921,2915,2019,2,NPS,6,frijol
Michoacán de Ocampo,2844,2844,2019,2,NPS,0,frijol
Morelos,640,640,2019,2,NPS,0,frijol
Nayarit,181,181,2019,2,D0,0,frijol
Nuevo León,1061,471,2019,2,NPS,590,frijol
Oaxaca,28769,28610,2019,2,NPS,159,frijol
Puebla,42539,41838,2019,2,D0,701,frijol
Querétaro de Arteaga,7324,7314,2019,2,D0,10,frijol
Quintana Roo,52,52,2019,2,NPS,0,frijol
San Luis Potosí,111914,63449,2019,2,D0,48465,frijol
Sinaloa,200,150,2019,2,D0,50,frijol
Sonora,626,626,2019,2,NPS,0,frijol
Tamaulipas,1206,984,2019,2,D1,222,frijol
Tlaxcala,2198,2198,2019,2,NPS,0,frijol
Veracruz de Ignacio de la Llave,12192,11599,2019,2,D0,593,frijol
Yucatán,6,6,2019,2,D0,0,frijol
Zacatecas,636256,632869,2019,2,NPS,3387,frijol
Aguascalientes,7391,7391,2019,3,NPS,0,frijol
Campeche,105,105,2019,3,D1,0,frijol
Coahuila de Zaragoza,2512,2507,2019,3,NPS,5,frijol
Chiapas,70071,69792,2019,3,D1,279,frijol
Chihuahua,87564,87530,2019,3,NPS,34,frijol
Ciudad de México,75,75,2019,3,NPS,0,frijol
Durango,216368,194843,2019,3,D0,21525,frijol
Guanajuato,62660,62660,2019,3,D0,0,frijol
Guerrero,11972,11972,2019,3,D0,0,frijol
Hidalgo,15268,13646,2019,3,D1,1622,frijol
Jalisco,8628,8628,2019,3,D0,0,frijol
Estado de México,2921,2921,2019,3,NPS,0,frijol
Michoacán de Ocampo,2844,2844,2019,3,NPS,0,frijol
Morelos,640,640,2019,3,NPS,0,frijol
Nayarit,181,181,2019,3,D0,0,frijol
Nuevo León,1061,471,2019,3,NPS,590,frijol
Oaxaca,28769,28610,2019,3,NPS,159,frijol
Puebla,42539,41838,2019,3,D0,701,frijol
Querétaro de Arteaga,7324,7314,2019,3,D0,10,frijol
Quintana Roo,52,52,2019,3,NPS,0,frijol
San Luis Potosí,111914,63449,2019,3,D1,48465,frijol
Sinaloa,200,150,2019,3,D1,50,frijol
Sonora,626,626,2019,3,NPS,0,frijol
Tamaulipas,1206,984,2019,3,D1,222,frijol
Tlaxcala,2198,2198,2019,3,NPS,0,frijol
Veracruz de Ignacio de la Llave,12192,11599,2019,3,D0,593,frijol
Yucatán,6,6,2019,3,D0,0,frijol
Zacatecas,636256,633309,2019,3,NPS,2947,frijol
Veracruz de Ignacio de la Llave,7829,54,2019,6,D0,7775,frijol
Puebla,43682,92,2019,7,D0,43590,frijol
Veracruz de Ignacio de la Llave,11614,81,2019,7,D1,11533,frijol
Chiapas,64492,5588,2019,8,D1,58904,frijol
Hidalgo,16144,215,2019,8,D0,15929,frijol
Puebla,44360,302,2019,8,NPS,44058,frijol
Tamaulipas,56,4,2019,8,D0,52,frijol
Veracruz de Ignacio de la Llave,11902,1113,2019,8,D2,10789,frijol
Chiapas,71978,32241,2019,9,D1,39737,frijol
Guanajuato,60010,315,2019,9,D0,59695,frijol
Guerrero,12533,123,2019,9,D1,12410,frijol
Hidalgo,16144,626,2019,9,D0,15518,frijol
Estado de México,4480,769,2019,9,D0,3711,frijol
Puebla,44455,1718,2019,9,NPS,42737,frijol
Tamaulipas,1952,4,2019,9,NPS,1948,frijol
Tlaxcala,2341,328,2019,9,NPS,2013,frijol
Veracruz de Ignacio de la Llave,11947,2648,2019,9,D3,9299,frijol
Aguascalientes,4598,1142,2019,10,D1,3456,frijol
Coahuila de Zaragoza,1863,56,2019,10,D0,1807,frijol
Chiapas,71978,49274,2019,10,D1,22704,frijol
Chihuahua,76894,1776,2019,10,NPS,75118,frijol
Ciudad de México,80,29,2019,10,D0,51,frijol
Durango,172414,400,2019,10,D1,172014,frijol
Guanajuato,60010,5558,2019,10,D0,54452,frijol
Guerrero,12533,1932,2019,10,NPS,10601,frijol
Hidalgo,16144,2893,2019,10,D0,13251,frijol
Jalisco,8134,493,2019,10,D0,7641,frijol
Estado de México,4480,1275,2019,10,D0,3205,frijol
Michoacán de Ocampo,2702,280,2019,10,D1,2422,frijol
Oaxaca,26922,1276,2019,10,NPS,25646,frijol
Puebla,44455,9024,2019,10,NPS,35431,frijol
San Luis Potosí,85641,4887,2019,10,D3,80754,frijol
Sonora,378,59,2019,10,NPS,319,frijol
Tamaulipas,1952,4,2019,10,D1,1948,frijol
Tlaxcala,2341,1013,2019,10,NPS,1328,frijol
Veracruz de Ignacio de la Llave,11947,3743,2019,10,D3,8204,frijol
Zacatecas,503813,1200,2019,10,D0,502613,frijol
Aguascalientes,4598,1913,2019,11,NPS,2685,frijol
Coahuila de Zaragoza,1863,557,2019,11,NPS,1306,frijol
Chiapas,71978,53552,2019,11,D0,18426,frijol
Chihuahua,76894,41156,2019,11,NPS,35738,frijol
Ciudad de México,80,75,2019,11,NPS,5,frijol
Durango,172414,42195,2019,11,D0,130219,frijol
Guanajuato,60010,30365,2019,11,D0,29645,frijol
Guerrero,12533,8497,2019,11,NPS,4036,frijol
Hidalgo,16144,12442,2019,11,D0,3702,frijol
Jalisco,8134,5214,2019,11,NPS,2920,frijol
Estado de México,4480,3039,2019,11,NPS,1441,frijol
Michoacán de Ocampo,2702,1065,2019,11,D0,1637,frijol
Morelos,524,410,2019,11,NPS,114,frijol
Nayarit,211,85,2019,11,D0,126,frijol
Nuevo León,3011,1257,2019,11,NPS,1754,frijol
Oaxaca,26922,8724,2019,11,NPS,18198,frijol
Puebla,44455,26276,2019,11,NPS,18179,frijol
Querétaro de Arteaga,6789,1589,2019,11,D1,5200,frijol
Quintana Roo,60,18,2019,11,NPS,42,frijol
San Luis Potosí,85641,9210,2019,11,D1,76431,frijol
Sonora,378,98,2019,11,NPS,280,frijol
Tamaulipas,1952,35,2019,11,D1,1917,frijol
Tlaxcala,2341,1846,2019,11,NPS,495,frijol
Veracruz de Ignacio de la Llave,11947,5136,2019,11,D2,6811,frijol
Zacatecas,503813,242613,2019,11,NPS,261200,frijol
Aguascalientes,4598,2171,2020,1,NPS,2427,frijol
Campeche,87,65,2020,1,NPS,22,frijol
Coahuila de Zaragoza,1863,1096,2020,1,NPS,767,frijol
Chiapas,71978,70686,2020,1,D0,1292,frijol
Chihuahua,76894,71554,2020,1,NPS,5340,frijol
Ciudad de México,80,80,2020,1,NPS,0,frijol
Durango,172414,170411,2020,1,NPS,2003,frijol
Guanajuato,60010,55061,2020,1,D0,4949,frijol
Guerrero,12533,12533,2020,1,NPS,0,frijol
Hidalgo,16144,13330,2020,1,D0,2814,frijol
Jalisco,8134,8017,2020,1,NPS,117,frijol
Estado de México,4480,3627,2020,1,NPS,853,frijol
Michoacán de Ocampo,2702,2322,2020,1,D1,380,frijol
Morelos,524,506,2020,1,NPS,18,frijol
Nayarit,211,211,2020,1,NPS,0,frijol
Nuevo León,3011,2918,2020,1,D0,93,frijol
Oaxaca,26922,26389,2020,1,NPS,533,frijol
Puebla,44455,41825,2020,1,NPS,2630,frijol
Querétaro de Arteaga,6789,4182,2020,1,D1,2607,frijol
Quintana Roo,60,32,2020,1,NPS,28,frijol
San Luis Potosí,85641,12014,2020,1,D3,73627,frijol
Sonora,378,300,2020,1,NPS,78,frijol
Tamaulipas,1952,1652,2020,1,D1,300,frijol
Tlaxcala,2341,2341,2020,1,NPS,0,frijol
Veracruz de Ignacio de la Llave,11947,11488,2020,1,D1,459,frijol
Yucatán,4,4,2020,1,NPS,0,frijol
Zacatecas,503813,395692,2020,1,NPS,108121,frijol
Aguascalientes,4598,2171,2020,2,NPS,2427,frijol
Campeche,87,87,2020,2,D0,0,frijol
Coahuila de Zaragoza,1863,1096,2020,2,D0,767,frijol
Chiapas,71978,71978,2020,2,D0,0,frijol
Chihuahua,76894,71554,2020,2,NPS,5340,frijol
Ciudad de México,80,80,2020,2,NPS,0,frijol
Durango,172414,170411,2020,2,NPS,2003,frijol
Guanajuato,60010,55061,2020,2,NPS,4949,frijol
Guerrero,12533,12533,2020,2,NPS,0,frijol
Hidalgo,16144,13330,2020,2,D0,2814,frijol
Jalisco,8134,8111,2020,2,NPS,23,frijol
Estado de México,4480,4428,2020,2,NPS,52,frijol
Michoacán de Ocampo,2702,2323,2020,2,D0,379,frijol
Morelos,524,506,2020,2,NPS,18,frijol
Nayarit,211,211,2020,2,NPS,0,frijol
Nuevo León,3011,2955,2020,2,D0,56,frijol
Oaxaca,26922,26389,2020,2,NPS,533,frijol
Puebla,44455,41825,2020,2,NPS,2630,frijol
Querétaro de Arteaga,6789,5880,2020,2,D0,909,frijol
Quintana Roo,60,32,2020,2,D0,28,frijol
San Luis Potosí,85641,12014,2020,2,D3,73627,frijol
Sonora,378,378,2020,2,NPS,0,frijol
Tamaulipas,1952,1952,2020,2,D1,0,frijol
Tlaxcala,2341,2341,2020,2,NPS,0,frijol
Veracruz de Ignacio de la Llave,11947,11488,2020,2,NPS,459,frijol
Yucatán,4,4,2020,2,D0,0,frijol
Zacatecas,503813,395692,2020,2,NPS,108121,frijol
Aguascalientes,4598,2171,2020,3,NPS,2427,frijol
Campeche,87,87,2020,3,D1,0,frijol
Coahuila de Zaragoza,1863,1096,2020,3,D0,767,frijol
Chiapas,71978,71978,2020,3,D0,0,frijol
Chihuahua,76894,71554,2020,3,NPS,5340,frijol
Ciudad de México,80,80,2020,3,NPS,0,frijol
Durango,172414,170411,2020,3,NPS,2003,frijol
Guanajuato,60010,55061,2020,3,D0,4949,frijol
Guerrero,12533,12533,2020,3,D0,0,frijol
Hidalgo,16144,13377,2020,3,D0,2767,frijol
Jalisco,8134,8134,2020,3,NPS,0,frijol
Estado de México,4480,4478,2020,3,NPS,2,frijol
Michoacán de Ocampo,2702,2353,2020,3,NPS,349,frijol
Morelos,524,524,2020,3,NPS,0,frijol
Nayarit,211,211,2020,3,NPS,0,frijol
Nuevo León,3011,2955,2020,3,D2,56,frijol
Oaxaca,26922,26707,2020,3,NPS,215,frijol
Puebla,44455,41825,2020,3,NPS,2630,frijol
Querétaro de Arteaga,6789,6787,2020,3,D0,2,frijol
Quintana Roo,60,32,2020,3,D0,28,frijol
San Luis Potosí,85641,12014,2020,3,NPS,73627,frijol
Sonora,378,378,2020,3,NPS,0,frijol
Tamaulipas,1952,1952,2020,3,D1,0,frijol
Tlaxcala,2341,2341,2020,3,D0,0,frijol
Veracruz de Ignacio de la Llave,11947,11917,2020,3,D0,30,frijol
Yucatán,4,4,2020,3,D0,0,frijol
Zacatecas,503813,395701,2020,3,NPS,108112,frijol
Puebla,40221,90,2020,7,D0,40131,frijol
Veracruz de Ignacio de la Llave,12136,81,2020,7,NPS,12055,frijol
Chiapas,67736,5024,2020,8,NPS,62712,frijol
Hidalgo,14839,199,2020,8,D0,14640,frijol
Puebla,41287,241,2020,8,NPS,41046,frijol
Veracruz de Ignacio de la Llave,13222,1422,2020,8,NPS,11800,frijol
Chiapas,72231,34808,2020,9,NPS,37423,frijol
Guerrero,12234,134,2020,9,D2,12100,frijol
Hidalgo,15171,444,2020,9,D0,14727,frijol
Estado de México,3923,671,2020,9,D0,3252,frijol
Puebla,41318,1512,2020,9,NPS,39806,frijol
Tlaxcala,2134,198,2020,9,NPS,1936,frijol
Veracruz de Ignacio de la Llave,13664,2960,2020,9,D0,10704,frijol
Aguascalientes,7235,2044,2020,10,D0,5191,frijol
Coahuila de Zaragoza,2180,94,2020,10,D0,2086,frijol
Chiapas,72231,50767,2020,10,NPS,21464,frijol
Chihuahua,66099,3040,2020,10,D1,63059,frijol
Ciudad de México,67,18,2020,10,NPS,49,frijol
Guanajuato,60816,7825,2020,10,D1,52991,frijol
Guerrero,12234,1391,2020,10,D2,10843,frijol
Hidalgo,15171,564,2020,10,D0,14607,frijol
Jalisco,9418,532,2020,10,D1,8886,frijol
Estado de México,3923,1294,2020,10,D0,2629,frijol
Michoacán de Ocampo,2372,426,2020,10,D1,1946,frijol
Oaxaca,28243,1313,2020,10,NPS,26930,frijol
Puebla,41318,5507,2020,10,NPS,35811,frijol
Querétaro de Arteaga,5361,100,2020,10,D0,5261,frijol
San Luis Potosí,125566,41234,2020,10,D1,84332,frijol
Sinaloa,184,150,2020,10,D1,34,frijol
Sonora,376,55,2020,10,D2,321,frijol
Tlaxcala,2134,784,2020,10,NPS,1350,frijol
Veracruz de Ignacio de la Llave,13664,4931,2020,10,D0,8733,frijol
Aguascalientes,7235,7134,2020,11,D0,101,frijol
Coahuila de Zaragoza,2180,2180,2020,11,D0,0,frijol
Chiapas,72231,56135,2020,11,NPS,16096,frijol
Chihuahua,66099,34403,2020,11,D2,31696,frijol
Ciudad de México,67,55,2020,11,NPS,12,frijol
Durango,234619,118461,2020,11,D0,116158,frijol
Guanajuato,60816,32893,2020,11,D1,27923,frijol
Guerrero,12234,7235,2020,11,D2,4999,frijol
Hidalgo,15171,8621,2020,11,D0,6550,frijol
Jalisco,9418,5984,2020,11,D1,3434,frijol
Estado de México,3923,3372,2020,11,D0,551,frijol
Michoacán de Ocampo,2372,1437,2020,11,D1,935,frijol
Morelos,682,535,2020,11,NPS,147,frijol
Nayarit,250,250,2020,11,D1,0,frijol
Nuevo León,930,59,2020,11,D0,871,frijol
Oaxaca,28243,9093,2020,11,NPS,19150,frijol
Puebla,41318,15980,2020,11,NPS,25338,frijol
Querétaro de Arteaga,5361,567,2020,11,D1,4794,frijol
Quintana Roo,52,13,2020,11,NPS,39,frijol
San Luis Potosí,125566,88960,2020,11,D1,36606,frijol
Sinaloa,184,150,2020,11,D2,34,frijol
Sonora,376,69,2020,11,D2,307,frijol
Tamaulipas,9030,98,2020,11,D1,8932,frijol
Tlaxcala,2134,1924,2020,11,NPS,210,frijol
Veracruz de Ignacio de la Llave,13664,10256,2020,11,D0,3408,frijol
Zacatecas,635812,489631,2020,11,D0,146181,frijol
Oaxaca,742,6,2004,1,NPS,736,trigo
Michoacán de Ocampo,988,195,2004,2,NPS,793,trigo
Oaxaca,742,18,2004,2,NPS,724,trigo
Michoacán de Ocampo,1051,200,2004,3,NPS,851,trigo
Oaxaca,742,25,2004,3,NPS,717,trigo
Coahuila de Zaragoza,1114,135,2004,4,NPS,979,trigo
Chiapas,100,81,2004,4,NPS,19,trigo
Chihuahua,260,49,2004,4,NPS,211,trigo
Estado de México,50,44,2004,4,NPS,6,trigo
Michoacán de Ocampo,1021,390,2004,4,NPS,631,trigo
Nuevo León,21498,13335,2004,4,NPS,8163,trigo
Oaxaca,742,387,2004,4,NPS,355,trigo
Puebla,110,102,2004,4,NPS,8,trigo
Tamaulipas,700,527,2004,4,NPS,173,trigo
Coahuila de Zaragoza,1114,732,2004,5,NPS,382,trigo
Chiapas,100,100,2004,5,NPS,0,trigo
Chihuahua,260,260,2004,5,NPS,0,trigo
Durango,391,391,2004,5,NPS,0,trigo
Jalisco,38,38,2004,5,NPS,0,trigo
Estado de México,50,50,2004,5,NPS,0,trigo
Michoacán de Ocampo,1033,741,2004,5,NPS,292,trigo
Nuevo León,21498,19987,2004,5,NPS,1511,trigo
Oaxaca,742,457,2004,5,NPS,285,trigo
Puebla,110,102,2004,5,NPS,8,trigo
Tamaulipas,600,527,2004,5,NPS,73,trigo
Coahuila de Zaragoza,391,391,2004,5,NPS,0,trigo
Durango,391,391,2004,5,NPS,0,trigo
Baja California,16493,760,2004,6,D1,15733,trigo
Coahuila de Zaragoza,1114,887,2004,6,NPS,227,trigo
Chiapas,100,100,2004,6,NPS,0,trigo
Chihuahua,260,260,2004,6,NPS,0,trigo
Durango,391,391,2004,6,NPS,0,trigo
Jalisco,38,38,2004,6,NPS,0,trigo
Estado de México,50,50,2004,6,NPS,0,trigo
Michoacán de Ocampo,1033,953,2004,6,NPS,80,trigo
Nuevo León,21536,20333,2004,6,NPS,1203,trigo
Oaxaca,742,457,2004,6,NPS,285,trigo
Puebla,110,102,2004,6,NPS,8,trigo
Tamaulipas,600,527,2004,6,NPS,73,trigo
Coahuila de Zaragoza,391,391,2004,6,NPS,0,trigo
Durango,391,391,2004,6,NPS,0,trigo
Baja California,16493,4167,2004,7,D1,12326,trigo
Coahuila de Zaragoza,1114,887,2004,7,NPS,227,trigo
Chiapas,100,100,2004,7,NPS,0,trigo
Chihuahua,260,260,2004,7,NPS,0,trigo
Durango,391,391,2004,7,NPS,0,trigo
Jalisco,38,38,2004,7,NPS,0,trigo
Estado de México,50,50,2004,7,NPS,0,trigo
Michoacán de Ocampo,1033,1016,2004,7,NPS,17,trigo
Nuevo León,21536,20333,2004,7,NPS,1203,trigo
Oaxaca,742,742,2004,7,NPS,0,trigo
Puebla,110,110,2004,7,NPS,0,trigo
Tamaulipas,600,532,2004,7,NPS,68,trigo
Coahuila de Zaragoza,391,391,2004,7,NPS,0,trigo
Durango,391,391,2004,7,NPS,0,trigo
Baja California,16493,6067,2004,8,D1,10426,trigo
Coahuila de Zaragoza,1114,887,2004,8,NPS,227,trigo
Chiapas,100,100,2004,8,D0,0,trigo
Chihuahua,260,260,2004,8,NPS,0,trigo
Durango,391,391,2004,8,NPS,0,trigo
Jalisco,38,38,2004,8,NPS,0,trigo
Estado de México,50,50,2004,8,NPS,0,trigo
Michoacán de Ocampo,1033,1027,2004,8,NPS,6,trigo
Nuevo León,21536,20333,2004,8,NPS,1203,trigo
Oaxaca,742,742,2004,8,NPS,0,trigo
Puebla,110,110,2004,8,NPS,0,trigo
Tamaulipas,600,532,2004,8,NPS,68,trigo
Coahuila de Zaragoza,391,391,2004,8,NPS,0,trigo
Durango,391,391,2004,8,NPS,0,trigo
Baja California,16493,6067,2004,9,D2,10426,trigo
Coahuila de Zaragoza,1114,887,2004,9,NPS,227,trigo
Chiapas,100,100,2004,9,D1,0,trigo
Chihuahua,260,260,2004,9,NPS,0,trigo
Durango,391,391,2004,9,NPS,0,trigo
Jalisco,38,38,2004,9,NPS,0,trigo
Estado de México,50,50,2004,9,NPS,0,trigo
Michoacán de Ocampo,1033,1033,2004,9,NPS,0,trigo
Nuevo León,21536,20333,2004,9,NPS,1203,trigo
Oaxaca,742,742,2004,9,D1,0,trigo
Puebla,110,110,2004,9,NPS,0,trigo
Tamaulipas,600,532,2004,9,NPS,68,trigo
Coahuila de Zaragoza,391,391,2004,9,NPS,0,trigo
Durango,391,391,2004,9,NPS,0,trigo
Baja California,16493,6067,2004,12,NPS,10426,trigo
Coahuila de Zaragoza,1114,887,2004,12,NPS,227,trigo
Chiapas,100,100,2004,12,D1,0,trigo
Chihuahua,260,260,2004,12,NPS,0,trigo
Durango,391,391,2004,12,NPS,0,trigo
Jalisco,38,38,2004,12,NPS,0,trigo
Estado de México,50,50,2004,12,NPS,0,trigo
Michoacán de Ocampo,1033,1033,2004,12,NPS,0,trigo
Nuevo León,21536,20333,2004,12,NPS,1203,trigo
Oaxaca,742,742,2004,12,D0,0,trigo
Puebla,110,110,2004,12,NPS,0,trigo
Tamaulipas,600,532,2004,12,NPS,68,trigo
Coahuila de Zaragoza,391,391,2004,12,NPS,0,trigo
Durango,391,391,2004,12,NPS,0,trigo
Oaxaca,648,4,2005,1,D0,644,trigo
Puebla,118,20,2005,1,NPS,98,trigo
Michoacán de Ocampo,526,20,2005,2,NPS,506,trigo
Oaxaca,648,20,2005,2,D0,628,trigo
Estado de México,30,6,2005,3,NPS,24,trigo
Michoacán de Ocampo,544,65,2005,3,NPS,479,trigo
Oaxaca,648,35,2005,3,NPS,613,trigo
Coahuila de Zaragoza,1232,252,2005,4,NPS,980,trigo
Chiapas,100,75,2005,4,D1,25,trigo
Estado de México,30,10,2005,4,NPS,20,trigo
Michoacán de Ocampo,544,223,2005,4,NPS,321,trigo
Nuevo León,12166,4000,2005,4,NPS,8166,trigo
Oaxaca,648,155,2005,4,D0,493,trigo
Puebla,129,53,2005,4,NPS,76,trigo
Coahuila de Zaragoza,1232,1145,2005,5,NPS,87,trigo
Chiapas,100,100,2005,5,D1,0,trigo
Chihuahua,290,142,2005,5,NPS,148,trigo
Durango,762,552,2005,5,NPS,210,trigo
Jalisco,35,35,2005,5,D0,0,trigo
Estado de México,30,30,2005,5,NPS,0,trigo
Michoacán de Ocampo,544,514,2005,5,D0,30,trigo
Nuevo León,12166,7000,2005,5,NPS,5166,trigo
Oaxaca,648,479,2005,5,NPS,169,trigo
Puebla,129,100,2005,5,NPS,29,trigo
Coahuila de Zaragoza,762,552,2005,5,NPS,210,trigo
Durango,762,552,2005,5,NPS,210,trigo
Baja California,14743,10,2005,6,NPS,14733,trigo
Coahuila de Zaragoza,1232,1170,2005,6,NPS,62,trigo
Chiapas,100,100,2005,6,NPS,0,trigo
Chihuahua,290,142,2005,6,NPS,148,trigo
Durango,762,552,2005,6,NPS,210,trigo
Jalisco,35,35,2005,6,D0,0,trigo
Estado de México,30,30,2005,6,D0,0,trigo
Michoacán de Ocampo,544,524,2005,6,D0,20,trigo
Nuevo León,12166,7025,2005,6,NPS,5141,trigo
Oaxaca,648,648,2005,6,NPS,0,trigo
Puebla,129,129,2005,6,NPS,0,trigo
Coahuila de Zaragoza,762,552,2005,6,NPS,210,trigo
Durango,762,552,2005,6,NPS,210,trigo
Baja California,14743,7465,2005,7,NPS,7278,trigo
Coahuila de Zaragoza,1232,1175,2005,7,NPS,57,trigo
Chiapas,100,100,2005,7,NPS,0,trigo
Chihuahua,290,162,2005,7,NPS,128,trigo
Durango,762,552,2005,7,NPS,210,trigo
Jalisco,35,35,2005,7,NPS,0,trigo
Estado de México,30,30,2005,7,NPS,0,trigo
Michoacán de Ocampo,544,524,2005,7,NPS,20,trigo
Nuevo León,12166,9470,2005,7,NPS,2696,trigo
Oaxaca,648,648,2005,7,NPS,0,trigo
Puebla,129,129,2005,7,NPS,0,trigo
Coahuila de Zaragoza,762,552,2005,7,NPS,210,trigo
Durango,762,552,2005,7,NPS,210,trigo
Baja California,14743,12134,2005,8,NPS,2609,trigo
Coahuila de Zaragoza,1232,1175,2005,8,NPS,57,trigo
Chiapas,100,100,2005,8,NPS,0,trigo
Chihuahua,290,162,2005,8,NPS,128,trigo
Durango,762,552,2005,8,NPS,210,trigo
Jalisco,35,35,2005,8,NPS,0,trigo
Estado de México,30,30,2005,8,NPS,0,trigo
Michoacán de Ocampo,544,524,2005,8,NPS,20,trigo
Nuevo León,12166,9470,2005,8,D0,2696,trigo
Oaxaca,648,648,2005,8,NPS,0,trigo
Puebla,129,129,2005,8,NPS,0,trigo
Coahuila de Zaragoza,762,552,2005,8,NPS,210,trigo
Durango,762,552,2005,8,NPS,210,trigo
Baja California,14743,14695,2005,9,NPS,48,trigo
Coahuila de Zaragoza,1232,1175,2005,9,D1,57,trigo
Chiapas,100,100,2005,9,NPS,0,trigo
Chihuahua,290,162,2005,9,NPS,128,trigo
Durango,762,552,2005,9,NPS,210,trigo
Jalisco,35,35,2005,9,D0,0,trigo
Estado de México,30,30,2005,9,D0,0,trigo
Michoacán de Ocampo,544,524,2005,9,D0,20,trigo
Nuevo León,12166,9470,2005,9,D0,2696,trigo
Oaxaca,648,648,2005,9,NPS,0,trigo
Puebla,129,129,2005,9,D0,0,trigo
Veracruz de Ignacio de la Llave,115,115,2005,9,NPS,0,trigo
Coahuila de Zaragoza,762,552,2005,9,D1,210,trigo
Durango,762,552,2005,9,NPS,210,trigo
Baja California,14743,14695,2005,12,NPS,48,trigo
Coahuila de Zaragoza,1232,1175,2005,12,D0,57,trigo
Chiapas,100,100,2005,12,NPS,0,trigo
Chihuahua,290,162,2005,12,D0,128,trigo
Durango,762,552,2005,12,D0,210,trigo
Jalisco,35,35,2005,12,D1,0,trigo
Estado de México,30,30,2005,12,D0,0,trigo
Michoacán de Ocampo,544,524,2005,12,D1,20,trigo
Nuevo León,12166,9470,2005,12,NPS,2696,trigo
Oaxaca,648,648,2005,12,NPS,0,trigo
Puebla,129,129,2005,12,D0,0,trigo
Veracruz de Ignacio de la Llave,115,115,2005,12,NPS,0,trigo
Coahuila de Zaragoza,762,552,2005,12,D0,210,trigo
Durango,762,552,2005,12,D0,210,trigo
Estado de México,30,10,2006,2,D1,20,trigo
Estado de México,30,10,2006,3,D2,20,trigo
Michoacán de Ocampo,1052,80,2006,3,D2,972,trigo
Coahuila de Zaragoza,562,60,2006,4,D1,502,trigo
Chiapas,100,60,2006,4,NPS,40,trigo
Estado de México,30,10,2006,4,D1,20,trigo
Michoacán de Ocampo,559,396,2006,4,D2,163,trigo
Puebla,153,52,2006,4,D1,101,trigo
Coahuila de Zaragoza,562,130,2006,5,D2,432,trigo
Chiapas,100,100,2006,5,NPS,0,trigo
Durango,345,200,2006,5,D2,145,trigo
Guanajuato,41,41,2006,5,D1,0,trigo
Estado de México,30,10,2006,5,D0,20,trigo
Michoacán de Ocampo,559,409,2006,5,D1,150,trigo
Nuevo León,13480,10210,2006,5,D0,3270,trigo
Oaxaca,621,245,2006,5,NPS,376,trigo
Puebla,153,72,2006,5,D0,81,trigo
Tamaulipas,437,437,2006,5,NPS,0,trigo
Coahuila de Zaragoza,345,200,2006,5,D2,145,trigo
Durango,345,200,2006,5,D2,145,trigo
Baja California,8702,150,2006,6,NPS,8552,trigo
Coahuila de Zaragoza,562,130,2006,6,D3,432,trigo
Chiapas,100,100,2006,6,NPS,0,trigo
Durango,345,263,2006,6,D2,82,trigo
Guanajuato,41,41,2006,6,D2,0,trigo
Estado de México,30,30,2006,6,D0,0,trigo
Michoacán de Ocampo,559,539,2006,6,D1,20,trigo
Nuevo León,13480,10280,2006,6,D1,3200,trigo
Oaxaca,628,627,2006,6,NPS,1,trigo
Puebla,153,82,2006,6,D0,71,trigo
Tamaulipas,437,437,2006,6,D0,0,trigo
Coahuila de Zaragoza,345,263,2006,6,D3,82,trigo
Durango,345,263,2006,6,D2,82,trigo
Baja California,8702,430,2006,7,NPS,8272,trigo
Coahuila de Zaragoza,562,130,2006,7,D3,432,trigo
Chiapas,100,100,2006,7,NPS,0,trigo
Durango,345,299,2006,7,D1,46,trigo
Guanajuato,41,41,2006,7,D0,0,trigo
Estado de México,30,30,2006,7,D0,0,trigo
Michoacán de Ocampo,563,548,2006,7,D0,15,trigo
Nuevo León,13480,13480,2006,7,D1,0,trigo
Oaxaca,628,627,2006,7,NPS,1,trigo
Puebla,153,82,2006,7,D0,71,trigo
Tamaulipas,437,437,2006,7,D0,0,trigo
Coahuila de Zaragoza,345,299,2006,7,D3,46,trigo
Durango,345,299,2006,7,D1,46,trigo
Baja California,8702,430,2006,8,D0,8272,trigo
Coahuila de Zaragoza,562,130,2006,8,D4,432,trigo
Chiapas,100,100,2006,8,NPS,0,trigo
Durango,345,299,2006,8,D0,46,trigo
Guanajuato,41,41,2006,8,NPS,0,trigo
Estado de México,30,30,2006,8,NPS,0,trigo
Michoacán de Ocampo,563,563,2006,8,D0,0,trigo
Nuevo León,13480,13480,2006,8,D3,0,trigo
Oaxaca,628,627,2006,8,NPS,1,trigo
Puebla,153,111,2006,8,D0,42,trigo
Tamaulipas,437,437,2006,8,D0,0,trigo
Veracruz de Ignacio de la Llave,155,155,2006,8,D1,0,trigo
Coahuila de Zaragoza,345,299,2006,8,D4,46,trigo
Durango,345,299,2006,8,D0,46,trigo
Baja California,8702,430,2006,9,D0,8272,trigo
Coahuila de Zaragoza,562,130,2006,9,NPS,432,trigo
Chiapas,100,100,2006,9,D0,0,trigo
Durango,345,299,2006,9,NPS,46,trigo
Guanajuato,41,41,2006,9,NPS,0,trigo
Estado de México,30,30,2006,9,NPS,0,trigo
Michoacán de Ocampo,563,563,2006,9,NPS,0,trigo
Nuevo León,13480,13480,2006,9,NPS,0,trigo
Oaxaca,628,627,2006,9,NPS,1,trigo
Puebla,153,111,2006,9,NPS,42,trigo
Tamaulipas,437,437,2006,9,D0,0,trigo
Veracruz de Ignacio de la Llave,155,155,2006,9,NPS,0,trigo
Coahuila de Zaragoza,345,299,2006,9,NPS,46,trigo
Durango,345,299,2006,9,NPS,46,trigo
Baja California,8702,430,2006,12,D1,8272,trigo
Coahuila de Zaragoza,562,130,2006,12,D0,432,trigo
Chiapas,100,100,2006,12,NPS,0,trigo
Durango,345,299,2006,12,NPS,46,trigo
Guanajuato,41,41,2006,12,NPS,0,trigo
Estado de México,30,30,2006,12,NPS,0,trigo
Michoacán de Ocampo,563,563,2006,12,NPS,0,trigo
Nuevo León,13480,13480,2006,12,NPS,0,trigo
Oaxaca,628,627,2006,12,NPS,1,trigo
Puebla,153,111,2006,12,NPS,42,trigo
Tamaulipas,437,437,2006,12,NPS,0,trigo
Veracruz de Ignacio de la Llave,155,155,2006,12,NPS,0,trigo
Coahuila de Zaragoza,345,299,2006,12,D0,46,trigo
Durango,345,299,2006,12,NPS,46,trigo
Chiapas,92,45,2007,4,D2,47,trigo
Durango,354,243,2007,4,D1,111,trigo
Michoacán de Ocampo,533,50,2007,4,D1,483,trigo
Nuevo León,19106,13385,2007,4,NPS,5721,trigo
Oaxaca,706,80,2007,4,D0,626,trigo
Puebla,92,57,2007,4,D0,35,trigo
San Luis Potosí,3,3,2007,4,NPS,0,trigo
Coahuila de Zaragoza,354,243,2007,4,D0,111,trigo
Durango,354,243,2007,4,D1,111,trigo
Coahuila de Zaragoza,771,45,2007,5,NPS,726,trigo
Chiapas,92,92,2007,5,D1,0,trigo
Chihuahua,282,154,2007,5,NPS,128,trigo
Durango,354,243,2007,5,D1,111,trigo
Guanajuato,20,20,2007,5,NPS,0,trigo
Estado de México,25,5,2007,5,NPS,20,trigo
Michoacán de Ocampo,783,680,2007,5,NPS,103,trigo
Nuevo León,19146,17103,2007,5,NPS,2043,trigo
Oaxaca,706,120,2007,5,NPS,586,trigo
Puebla,92,77,2007,5,NPS,15,trigo
San Luis Potosí,3,3,2007,5,NPS,0,trigo
Tamaulipas,195,195,2007,5,NPS,0,trigo
Coahuila de Zaragoza,354,243,2007,5,NPS,111,trigo
Durango,354,243,2007,5,D1,111,trigo
Coahuila de Zaragoza,771,95,2007,6,NPS,676,trigo
Chiapas,92,92,2007,6,D1,0,trigo
Chihuahua,282,254,2007,6,NPS,28,trigo
Durango,354,354,2007,6,D0,0,trigo
Guanajuato,20,20,2007,6,NPS,0,trigo
Jalisco,25,25,2007,6,D3,0,trigo
Estado de México,25,25,2007,6,D1,0,trigo
Michoacán de Ocampo,783,738,2007,6,D1,45,trigo
Nuevo León,19106,18296,2007,6,NPS,810,trigo
Oaxaca,706,706,2007,6,D0,0,trigo
Puebla,92,92,2007,6,D0,0,trigo
San Luis Potosí,3,3,2007,6,NPS,0,trigo
Tamaulipas,195,195,2007,6,NPS,0,trigo
Coahuila de Zaragoza,354,354,2007,6,NPS,0,trigo
Durango,354,354,2007,6,D0,0,trigo
Coahuila de Zaragoza,771,95,2007,7,NPS,676,trigo
Chiapas,92,92,2007,7,NPS,0,trigo
Chihuahua,282,254,2007,7,D0,28,trigo
Durango,354,354,2007,7,NPS,0,trigo
Guanajuato,20,20,2007,7,NPS,0,trigo
Jalisco,25,25,2007,7,D1,0,trigo
Estado de México,25,25,2007,7,NPS,0,trigo
Michoacán de Ocampo,783,760,2007,7,D3,23,trigo
Nuevo León,19106,18589,2007,7,NPS,517,trigo
Oaxaca,706,706,2007,7,NPS,0,trigo
Puebla,92,92,2007,7,D1,0,trigo
San Luis Potosí,3,3,2007,7,NPS,0,trigo
Tamaulipas,195,195,2007,7,NPS,0,trigo
Coahuila de Zaragoza,354,354,2007,7,NPS,0,trigo
Durango,354,354,2007,7,NPS,0,trigo
Baja California,7316,15,2007,8,D3,7301,trigo
Coahuila de Zaragoza,771,648,2007,8,NPS,123,trigo
Chiapas,92,92,2007,8,NPS,0,trigo
Chihuahua,282,254,2007,8,NPS,28,trigo
Durango,354,354,2007,8,NPS,0,trigo
Guanajuato,20,20,2007,8,NPS,0,trigo
Jalisco,25,25,2007,8,NPS,0,trigo
Estado de México,25,25,2007,8,NPS,0,trigo
Michoacán de Ocampo,783,768,2007,8,NPS,15,trigo
Nuevo León,19106,18589,2007,8,NPS,517,trigo
Oaxaca,706,706,2007,8,NPS,0,trigo
Puebla,92,92,2007,8,NPS,0,trigo
San Luis Potosí,3,3,2007,8,NPS,0,trigo
Tamaulipas,195,195,2007,8,NPS,0,trigo
Veracruz de Ignacio de la Llave,155,155,2007,8,NPS,0,trigo
Coahuila de Zaragoza,354,354,2007,8,NPS,0,trigo
Durango,354,354,2007,8,NPS,0,trigo
Baja California,7316,15,2007,9,D3,7301,trigo
Coahuila de Zaragoza,771,648,2007,9,NPS,123,trigo
Chiapas,92,92,2007,9,D0,0,trigo
Chihuahua,282,254,2007,9,D0,28,trigo
Durango,354,354,2007,9,D0,0,trigo
Guanajuato,20,20,2007,9,NPS,0,trigo
Jalisco,25,25,2007,9,D0,0,trigo
Estado de México,25,25,2007,9,NPS,0,trigo
Michoacán de Ocampo,783,783,2007,9,D0,0,trigo
Nuevo León,19106,18589,2007,9,NPS,517,trigo
Oaxaca,706,706,2007,9,NPS,0,trigo
Puebla,92,92,2007,9,NPS,0,trigo
San Luis Potosí,3,3,2007,9,NPS,0,trigo
Sonora,71,2,2007,9,NPS,69,trigo
Tamaulipas,195,195,2007,9,NPS,0,trigo
Veracruz de Ignacio de la Llave,155,155,2007,9,NPS,0,trigo
Coahuila de Zaragoza,354,354,2007,9,NPS,0,trigo
Durango,354,354,2007,9,D0,0,trigo
Baja California,7316,15,2007,12,D2,7301,trigo
Coahuila de Zaragoza,771,648,2007,12,D0,123,trigo
Chiapas,92,92,2007,12,NPS,0,trigo
Chihuahua,282,254,2007,12,D0,28,trigo
Durango,354,354,2007,12,D1,0,trigo
Guanajuato,20,20,2007,12,NPS,0,trigo
Jalisco,25,25,2007,12,D2,0,trigo
Estado de México,25,25,2007,12,NPS,0,trigo
Michoacán de Ocampo,783,783,2007,12,NPS,0,trigo
Nuevo León,19106,18589,2007,12,D0,517,trigo
Oaxaca,706,706,2007,12,NPS,0,trigo
Puebla,92,92,2007,12,NPS,0,trigo
San Luis Potosí,3,3,2007,12,NPS,0,trigo
Sonora,71,2,2007,12,NPS,69,trigo
Tamaulipas,195,195,2007,12,D0,0,trigo
Veracruz de Ignacio de la Llave,155,155,2007,12,NPS,0,trigo
Coahuila de Zaragoza,354,354,2007,12,D0,0,trigo
Durango,354,354,2007,12,D1,0,trigo
Michoacán de Ocampo,467,30,2008,3,D1,437,trigo
Chiapas,84,37,2008,4,NPS,47,trigo
Guanajuato,55,55,2008,4,D1,0,trigo
Michoacán de Ocampo,467,65,2008,4,D2,402,trigo
Nuevo León,5435,1340,2008,4,D1,4095,trigo
Puebla,107,92,2008,4,D0,15,trigo
Chiapas,84,84,2008,5,NPS,0,trigo
Chihuahua,208,93,2008,5,D0,115,trigo
Guanajuato,55,55,2008,5,D1,0,trigo
Michoacán de Ocampo,467,427,2008,5,D3,40,trigo
Nuevo León,5435,2640,2008,5,D1,2795,trigo
Oaxaca,739,80,2008,5,D0,659,trigo
Puebla,107,107,2008,5,D0,0,trigo
Chiapas,84,84,2008,6,NPS,0,trigo
Chihuahua,208,93,2008,6,D1,115,trigo
Guanajuato,55,55,2008,6,D1,0,trigo
Estado de México,20,20,2008,6,D1,0,trigo
Michoacán de Ocampo,467,429,2008,6,D3,38,trigo
Nuevo León,5435,2640,2008,6,D2,2795,trigo
Oaxaca,739,739,2008,6,NPS,0,trigo
Puebla,107,107,2008,6,D0,0,trigo
Baja California,14348,3865,2008,7,D1,10483,trigo
Chiapas,84,84,2008,7,NPS,0,trigo
Chihuahua,208,93,2008,7,NPS,115,trigo
Guanajuato,55,55,2008,7,D1,0,trigo
Estado de México,20,20,2008,7,D0,0,trigo
Michoacán de Ocampo,467,429,2008,7,D1,38,trigo
Nuevo León,5435,2640,2008,7,NPS,2795,trigo
Oaxaca,739,739,2008,7,NPS,0,trigo
Puebla,107,107,2008,7,NPS,0,trigo
Baja California,14348,7003,2008,8,D1,7345,trigo
Chiapas,84,84,2008,8,NPS,0,trigo
Chihuahua,208,93,2008,8,NPS,115,trigo
Guanajuato,55,55,2008,8,D1,0,trigo
Estado de México,20,20,2008,8,D0,0,trigo
Michoacán de Ocampo,467,432,2008,8,D2,35,trigo
Nuevo León,5435,2695,2008,8,NPS,2740,trigo
Oaxaca,739,739,2008,8,NPS,0,trigo
Puebla,107,107,2008,8,NPS,0,trigo
Baja California,14348,9688,2008,9,D2,4660,trigo
Chiapas,84,84,2008,9,NPS,0,trigo
Chihuahua,208,93,2008,9,NPS,115,trigo
Guanajuato,55,55,2008,9,NPS,0,trigo
Estado de México,20,20,2008,9,D0,0,trigo
Michoacán de Ocampo,467,442,2008,9,D1,25,trigo
Nuevo León,5435,2695,2008,9,NPS,2740,trigo
Oaxaca,739,739,2008,9,NPS,0,trigo
Puebla,107,107,2008,9,NPS,0,trigo
Veracruz de Ignacio de la Llave,79,79,2008,9,D0,0,trigo
Baja California,14348,9688,2008,12,D1,4660,trigo
Chiapas,84,84,2008,12,D0,0,trigo
Chihuahua,208,93,2008,12,NPS,115,trigo
Guanajuato,55,55,2008,12,D0,0,trigo
Estado de México,20,20,2008,12,D1,0,trigo
Michoacán de Ocampo,467,442,2008,12,D1,25,trigo
Nuevo León,5435,2695,2008,12,NPS,2740,trigo
Oaxaca,739,739,2008,12,NPS,0,trigo
Puebla,107,107,2008,12,NPS,0,trigo
Veracruz de Ignacio de la Llave,79,79,2008,12,D0,0,trigo
Estado de México,20,20,2009,3,D1,0,trigo
Michoacán de Ocampo,429,24,2009,3,D1,405,trigo
Tamaulipas,400,100,2009,3,NPS,300,trigo
Chiapas,69,32,2009,4,D0,37,trigo
Durango,1170,1170,2009,4,NPS,0,trigo
Guanajuato,15,15,2009,4,D0,0,trigo
Estado de México,20,20,2009,4,D1,0,trigo
Michoacán de Ocampo,519,150,2009,4,D1,369,trigo
Nuevo León,9550,7240,2009,4,NPS,2310,trigo
Oaxaca,723,70,2009,4,NPS,653,trigo
Puebla,134,84,2009,4,D0,50,trigo
Tamaulipas,400,300,2009,4,NPS,100,trigo
Coahuila de Zaragoza,1170,1170,2009,4,D0,0,trigo
Durango,1170,1170,2009,4,NPS,0,trigo
Chiapas,69,69,2009,5,NPS,0,trigo
Durango,1170,1170,2009,5,NPS,0,trigo
Guanajuato,15,15,2009,5,D0,0,trigo
Estado de México,20,20,2009,5,D1,0,trigo
Michoacán de Ocampo,519,389,2009,5,D1,130,trigo
Nuevo León,9550,8840,2009,5,NPS,710,trigo
Oaxaca,723,120,2009,5,NPS,603,trigo
Puebla,134,129,2009,5,D0,5,trigo
Tamaulipas,400,300,2009,5,NPS,100,trigo
Veracruz de Ignacio de la Llave,154,154,2009,5,D0,0,trigo
Coahuila de Zaragoza,1170,1170,2009,5,D0,0,trigo
Durango,1170,1170,2009,5,NPS,0,trigo
Baja California,13277,988,2009,6,D2,12289,trigo
Chiapas,69,69,2009,6,NPS,0,trigo
Durango,1170,1170,2009,6,NPS,0,trigo
Guanajuato,15,15,2009,6,D1,0,trigo
Estado de México,20,20,2009,6,D1,0,trigo
Michoacán de Ocampo,519,494,2009,6,D1,25,trigo
Nuevo León,9550,8840,2009,6,NPS,710,trigo
Oaxaca,723,723,2009,6,NPS,0,trigo
Puebla,134,134,2009,6,D0,0,trigo
Tamaulipas,400,300,2009,6,NPS,100,trigo
Veracruz de Ignacio de la Llave,154,154,2009,6,D0,0,trigo
Coahuila de Zaragoza,1170,1170,2009,6,D0,0,trigo
Durango,1170,1170,2009,6,NPS,0,trigo
Baja California,13277,4643,2009,7,D2,8634,trigo
Chiapas,69,69,2009,7,D0,0,trigo
Durango,1170,1170,2009,7,NPS,0,trigo
Guanajuato,15,15,2009,7,D1,0,trigo
Estado de México,20,20,2009,7,D1,0,trigo
Michoacán de Ocampo,519,499,2009,7,D2,20,trigo
Nuevo León,9550,9350,2009,7,D0,200,trigo
Oaxaca,723,723,2009,7,NPS,0,trigo
Puebla,134,134,2009,7,D0,0,trigo
Tamaulipas,400,300,2009,7,D0,100,trigo
Veracruz de Ignacio de la Llave,154,154,2009,7,D0,0,trigo
Coahuila de Zaragoza,1170,1170,2009,7,D1,0,trigo
Durango,1170,1170,2009,7,NPS,0,trigo
Baja California,13277,6280,2009,8,D2,6997,trigo
Chiapas,69,69,2009,8,D1,0,trigo
Durango,1170,1170,2009,8,NPS,0,trigo
Guanajuato,15,15,2009,8,D1,0,trigo
Estado de México,20,20,2009,8,D1,0,trigo
Michoacán de Ocampo,519,515,2009,8,D2,4,trigo
Nuevo León,9550,9350,2009,8,D0,200,trigo
Oaxaca,723,723,2009,8,D0,0,trigo
Puebla,134,134,2009,8,D1,0,trigo
Tamaulipas,400,300,2009,8,D3,100,trigo
Veracruz de Ignacio de la Llave,154,154,2009,8,D1,0,trigo
Coahuila de Zaragoza,1170,1170,2009,8,D2,0,trigo
Durango,1170,1170,2009,8,NPS,0,trigo
Baja California,13277,6280,2009,9,D2,6997,trigo
Chiapas,69,69,2009,9,D2,0,trigo
Durango,1170,1170,2009,9,NPS,0,trigo
Guanajuato,15,15,2009,9,D1,0,trigo
Estado de México,20,20,2009,9,D1,0,trigo
Michoacán de Ocampo,519,519,2009,9,D2,0,trigo
Nuevo León,9550,9350,2009,9,D1,200,trigo
Oaxaca,723,723,2009,9,NPS,0,trigo
Puebla,134,134,2009,9,NPS,0,trigo
Tamaulipas,400,300,2009,9,D1,100,trigo
Veracruz de Ignacio de la Llave,154,154,2009,9,NPS,0,trigo
Coahuila de Zaragoza,1170,1170,2009,9,D2,0,trigo
Baja California,13277,6280,2009,12,D1,6997,trigo
Chiapas,69,69,2009,12,D2,0,trigo
Durango,1170,1170,2009,12,NPS,0,trigo
Guanajuato,15,15,2009,12,D1,0,trigo
Estado de México,20,20,2009,12,D1,0,trigo
Michoacán de Ocampo,519,519,2009,12,D2,0,trigo
Nuevo León,9550,9350,2009,12,NPS,200,trigo
Oaxaca,723,723,2009,12,NPS,0,trigo
Puebla,134,134,2009,12,D0,0,trigo
Tamaulipas,400,300,2009,12,D0,100,trigo
Veracruz de Ignacio de la Llave,154,154,2009,12,NPS,0,trigo
Coahuila de Zaragoza,1170,1170,2009,12,D1,0,trigo
Oaxaca,672,115,2010,2,NPS,557,trigo
Oaxaca,672,215,2010,3,NPS,457,trigo
Chiapas,54,27,2010,4,D3,27,trigo
Michoacán de Ocampo,610,158,2010,4,NPS,452,trigo
Nuevo León,14240,3237,2010,4,NPS,11003,trigo
Oaxaca,672,552,2010,4,NPS,120,trigo
Puebla,97,10,2010,4,NPS,87,trigo
Baja California,13187,18,2010,5,NPS,13169,trigo
Coahuila de Zaragoza,448,70,2010,5,NPS,378,trigo
Chiapas,54,54,2010,5,D2,0,trigo
Chihuahua,233,143,2010,5,NPS,90,trigo
Michoacán de Ocampo,610,495,2010,5,NPS,115,trigo
Nuevo León,14240,6977,2010,5,NPS,7263,trigo
Oaxaca,672,587,2010,5,NPS,85,trigo
Puebla,97,10,2010,5,NPS,87,trigo
Tamaulipas,90,90,2010,5,NPS,0,trigo
Baja California,13187,23,2010,6,NPS,13164,trigo
Coahuila de Zaragoza,448,70,2010,6,NPS,378,trigo
Chiapas,54,54,2010,6,D2,0,trigo
Chihuahua,233,152,2010,6,NPS,81,trigo
Durango,422,10,2010,6,NPS,412,trigo
Estado de México,15,15,2010,6,NPS,0,trigo
Michoacán de Ocampo,610,588,2010,6,NPS,22,trigo
Nuevo León,14240,11512,2010,6,NPS,2728,trigo
Oaxaca,672,672,2010,6,NPS,0,trigo
Puebla,97,65,2010,6,NPS,32,trigo
Tamaulipas,90,90,2010,6,NPS,0,trigo
Coahuila de Zaragoza,422,10,2010,6,NPS,412,trigo
Baja California,13187,2837,2010,7,NPS,10350,trigo
Coahuila de Zaragoza,448,70,2010,7,NPS,378,trigo
Chiapas,54,54,2010,7,NPS,0,trigo
Chihuahua,152,152,2010,7,NPS,0,trigo
Durango,422,422,2010,7,NPS,0,trigo
Estado de México,15,15,2010,7,NPS,0,trigo
Michoacán de Ocampo,610,593,2010,7,NPS,17,trigo
Nuevo León,14240,11512,2010,7,NPS,2728,trigo
Oaxaca,672,672,2010,7,NPS,0,trigo
Puebla,97,65,2010,7,NPS,32,trigo
Sonora,2,2,2010,7,NPS,0,trigo
Tamaulipas,90,90,2010,7,NPS,0,trigo
Coahuila de Zaragoza,422,422,2010,7,NPS,0,trigo
Baja California,13071,7520,2010,8,NPS,5551,trigo
Coahuila de Zaragoza,448,441,2010,8,NPS,7,trigo
Chiapas,54,54,2010,8,NPS,0,trigo
Chihuahua,152,152,2010,8,NPS,0,trigo
Durango,422,422,2010,8,NPS,0,trigo
Estado de México,15,15,2010,8,NPS,0,trigo
Michoacán de Ocampo,610,602,2010,8,NPS,8,trigo
Nuevo León,14240,12012,2010,8,NPS,2228,trigo
Oaxaca,672,672,2010,8,NPS,0,trigo
Puebla,97,97,2010,8,NPS,0,trigo
Sonora,2,2,2010,8,NPS,0,trigo
Tamaulipas,90,90,2010,8,NPS,0,trigo
Veracruz de Ignacio de la Llave,154,154,2010,8,NPS,0,trigo
Coahuila de Zaragoza,422,422,2010,8,NPS,0,trigo
Baja California,13071,11949,2010,9,NPS,1122,trigo
Coahuila de Zaragoza,448,441,2010,9,NPS,7,trigo
Chiapas,54,54,2010,9,NPS,0,trigo
Chihuahua,152,152,2010,9,NPS,0,trigo
Durango,422,422,2010,9,NPS,0,trigo
Estado de México,15,15,2010,9,NPS,0,trigo
Michoacán de Ocampo,610,604,2010,9,NPS,6,trigo
Nuevo León,14240,12012,2010,9,NPS,2228,trigo
Oaxaca,672,672,2010,9,NPS,0,trigo
Puebla,97,97,2010,9,NPS,0,trigo
Sonora,4,4,2010,9,NPS,0,trigo
Tamaulipas,90,90,2010,9,NPS,0,trigo
Veracruz de Ignacio de la Llave,154,154,2010,9,NPS,0,trigo
Coahuila de Zaragoza,422,422,2010,9,NPS,0,trigo
Baja California,13071,11949,2010,12,NPS,1122,trigo
Coahuila de Zaragoza,448,441,2010,12,D2,7,trigo
Chiapas,54,54,2010,12,NPS,0,trigo
Chihuahua,152,152,2010,12,D0,0,trigo
Durango,422,422,2010,12,NPS,0,trigo
Estado de México,15,15,2010,12,NPS,0,trigo
Michoacán de Ocampo,610,604,2010,12,NPS,6,trigo
Nuevo León,14240,12012,2010,12,NPS,2228,trigo
Oaxaca,672,672,2010,12,NPS,0,trigo
Puebla,97,97,2010,12,NPS,0,trigo
Sonora,4,4,2010,12,D0,0,trigo
Tamaulipas,90,90,2010,12,NPS,0,trigo
Veracruz de Ignacio de la Llave,154,154,2010,12,NPS,0,trigo
Coahuila de Zaragoza,422,422,2010,12,D2,0,trigo
Baja California,10751,14,2011,4,NPS,10737,trigo
Chiapas,45,23,2011,4,D1,22,trigo
Michoacán de Ocampo,811,373,2011,4,D1,438,trigo
Nuevo León,6850,3050,2011,4,D3,3800,trigo
Oaxaca,655,565,2011,4,D0,90,trigo
Puebla,104,11,2011,4,D1,93,trigo
Baja California,10751,14,2011,5,NPS,10737,trigo
Chiapas,45,45,2011,5,NPS,0,trigo
Michoacán de Ocampo,804,640,2011,5,D1,164,trigo
Nuevo León,6850,4200,2011,5,D3,2650,trigo
Oaxaca,655,570,2011,5,D0,85,trigo
Puebla,104,56,2011,5,D1,48,trigo
Baja California,10751,20,2011,6,NPS,10731,trigo
Chiapas,45,45,2011,6,D0,0,trigo
Michoacán de Ocampo,804,679,2011,6,D3,125,trigo
Nuevo León,6850,4200,2011,6,D3,2650,trigo
Oaxaca,655,655,2011,6,NPS,0,trigo
Puebla,115,67,2011,6,D2,48,trigo
Baja California,10751,5640,2011,7,NPS,5111,trigo
Chiapas,45,45,2011,7,NPS,0,trigo
Michoacán de Ocampo,804,684,2011,7,D2,120,trigo
Nuevo León,6850,4200,2011,7,D2,2650,trigo
Oaxaca,655,655,2011,7,NPS,0,trigo
Puebla,115,67,2011,7,D1,48,trigo
Baja California,10751,7889,2011,8,NPS,2862,trigo
Chiapas,45,45,2011,8,NPS,0,trigo
Michoacán de Ocampo,804,697,2011,8,D2,107,trigo
Nuevo León,6850,4200,2011,8,D3,2650,trigo
Oaxaca,655,655,2011,8,NPS,0,trigo
Puebla,115,115,2011,8,D0,0,trigo
Veracruz de Ignacio de la Llave,154,154,2011,8,D1,0,trigo
Baja California,10751,7889,2011,9,NPS,2862,trigo
Chiapas,45,45,2011,9,NPS,0,trigo
Michoacán de Ocampo,804,697,2011,9,D1,107,trigo
Nuevo León,6850,4200,2011,9,D3,2650,trigo
Oaxaca,655,655,2011,9,NPS,0,trigo
Puebla,115,115,2011,9,NPS,0,trigo
Veracruz de Ignacio de la Llave,154,154,2011,9,NPS,0,trigo
Baja California,10751,7889,2011,12,NPS,2862,trigo
Chiapas,45,45,2011,12,NPS,0,trigo
Michoacán de Ocampo,804,697,2011,12,D0,107,trigo
Nuevo León,6850,4200,2011,12,D3,2650,trigo
Oaxaca,655,655,2011,12,NPS,0,trigo
Puebla,115,115,2011,12,NPS,0,trigo
Veracruz de Ignacio de la Llave,154,154,2011,12,D0,0,trigo
Michoacán de Ocampo,631,125,2012,3,NPS,506,trigo
Puebla,128,20,2012,3,NPS,108,trigo
Chiapas,37,37,2012,4,NPS,0,trigo
Michoacán de Ocampo,631,287,2012,4,NPS,344,trigo
Nuevo León,8521,3446,2012,4,D0,5075,trigo
Oaxaca,680,125,2012,4,NPS,555,trigo
Puebla,128,20,2012,4,NPS,108,trigo
Veracruz de Ignacio de la Llave,154,54,2012,4,NPS,100,trigo
Chiapas,37,37,2012,5,NPS,0,trigo
Chihuahua,202,119,2012,5,D2,83,trigo
Michoacán de Ocampo,631,513,2012,5,NPS,118,trigo
Nuevo León,8521,6223,2012,5,NPS,2298,trigo
Oaxaca,680,595,2012,5,NPS,85,trigo
Puebla,128,41,2012,5,NPS,87,trigo
Sinaloa,862,55,2012,5,D0,807,trigo
Veracruz de Ignacio de la Llave,154,90,2012,5,NPS,64,trigo
Chiapas,37,37,2012,6,NPS,0,trigo
Chihuahua,202,119,2012,6,D2,83,trigo
Estado de México,25,25,2012,6,NPS,0,trigo
Michoacán de Ocampo,631,615,2012,6,NPS,16,trigo
Nuevo León,8521,6223,2012,6,NPS,2298,trigo
Oaxaca,680,680,2012,6,NPS,0,trigo
Puebla,128,41,2012,6,NPS,87,trigo
Sinaloa,2054,862,2012,6,NPS,1192,trigo
Veracruz de Ignacio de la Llave,154,100,2012,6,NPS,54,trigo
Baja California,11245,1795,2012,7,NPS,9450,trigo
Chiapas,37,37,2012,7,NPS,0,trigo
Chihuahua,202,119,2012,7,D1,83,trigo
Estado de México,25,25,2012,7,NPS,0,trigo
Michoacán de Ocampo,631,626,2012,7,NPS,5,trigo
Nuevo León,8521,6223,2012,7,NPS,2298,trigo
Oaxaca,680,680,2012,7,NPS,0,trigo
Puebla,128,66,2012,7,NPS,62,trigo
Sinaloa,2090,862,2012,7,NPS,1228,trigo
Veracruz de Ignacio de la Llave,154,124,2012,7,NPS,30,trigo
Baja California,11245,5620,2012,8,NPS,5625,trigo
Chiapas,37,37,2012,8,NPS,0,trigo
Chihuahua,202,119,2012,8,D1,83,trigo
Estado de México,25,25,2012,8,NPS,0,trigo
Michoacán de Ocampo,631,631,2012,8,NPS,0,trigo
Nuevo León,8521,6398,2012,8,D0,2123,trigo
Oaxaca,680,680,2012,8,NPS,0,trigo
Puebla,128,66,2012,8,NPS,62,trigo
Sinaloa,1440,212,2012,8,NPS,1228,trigo
Veracruz de Ignacio de la Llave,154,154,2012,8,NPS,0,trigo
Baja California,11245,5873,2012,9,NPS,5372,trigo
Chiapas,37,37,2012,9,NPS,0,trigo
Chihuahua,202,119,2012,9,D1,83,trigo
Estado de México,25,25,2012,9,NPS,0,trigo
Michoacán de Ocampo,631,631,2012,9,NPS,0,trigo
Nuevo León,8521,6398,2012,9,D0,2123,trigo
Oaxaca,680,680,2012,9,NPS,0,trigo
Puebla,128,128,2012,9,NPS,0,trigo
Sinaloa,1440,212,2012,9,NPS,1228,trigo
Veracruz de Ignacio de la Llave,154,154,2012,9,NPS,0,trigo
Baja California,11245,5873,2012,12,D0,5372,trigo
Chiapas,37,37,2012,12,NPS,0,trigo
Chihuahua,202,119,2012,12,NPS,83,trigo
Estado de México,25,25,2012,12,NPS,0,trigo
Michoacán de Ocampo,631,631,2012,12,NPS,0,trigo
Nuevo León,8521,6398,2012,12,D0,2123,trigo
Oaxaca,680,680,2012,12,NPS,0,trigo
Puebla,128,128,2012,12,NPS,0,trigo
Sinaloa,1440,212,2012,12,NPS,1228,trigo
Veracruz de Ignacio de la Llave,154,154,2012,12,NPS,0,trigo
Chihuahua,207,196,2013,4,NPS,11,trigo
Durango,176,26,2013,4,D0,150,trigo
Michoacán de Ocampo,632,130,2013,4,NPS,502,trigo
Nuevo León,14936,6050,2013,4,D0,8886,trigo
Oaxaca,691,481,2013,4,NPS,210,trigo
Tamaulipas,1200,1200,2013,4,D0,0,trigo
Coahuila de Zaragoza,176,26,2013,4,D1,150,trigo
Chiapas,31,31,2013,5,NPS,0,trigo
Chihuahua,207,207,2013,5,D0,0,trigo
Durango,176,26,2013,5,D1,150,trigo
Michoacán de Ocampo,632,487,2013,5,NPS,145,trigo
Nuevo León,14936,12190,2013,5,NPS,2746,trigo
Oaxaca,691,606,2013,5,NPS,85,trigo
Puebla,137,45,2013,5,NPS,92,trigo
Tamaulipas,1200,1200,2013,5,D0,0,trigo
Coahuila de Zaragoza,176,26,2013,5,D0,150,trigo
Chiapas,31,31,2013,6,NPS,0,trigo
Chihuahua,207,207,2013,6,D0,0,trigo
Durango,176,26,2013,6,D1,150,trigo
Michoacán de Ocampo,632,579,2013,6,NPS,53,trigo
Nuevo León,14936,12190,2013,6,NPS,2746,trigo
Oaxaca,691,691,2013,6,NPS,0,trigo
Puebla,137,65,2013,6,NPS,72,trigo
Sonora,15,15,2013,6,D0,0,trigo
Tamaulipas,1200,1200,2013,6,D0,0,trigo
Coahuila de Zaragoza,176,26,2013,6,NPS,150,trigo
Baja California,10018,3420,2013,7,D1,6598,trigo
Chiapas,31,31,2013,7,NPS,0,trigo
Chihuahua,207,207,2013,7,NPS,0,trigo
Durango,176,26,2013,7,D0,150,trigo
Michoacán de Ocampo,632,582,2013,7,NPS,50,trigo
Nuevo León,14936,12405,2013,7,NPS,2531,trigo
Oaxaca,691,691,2013,7,NPS,0,trigo
Puebla,137,65,2013,7,NPS,72,trigo
Sonora,15,15,2013,7,D0,0,trigo
Tamaulipas,1200,1200,2013,7,D1,0,trigo
Veracruz de Ignacio de la Llave,68,36,2013,7,NPS,32,trigo
Coahuila de Zaragoza,176,26,2013,7,NPS,150,trigo
Baja California,10018,3420,2013,8,D1,6598,trigo
Chiapas,31,31,2013,8,NPS,0,trigo
Chihuahua,207,207,2013,8,NPS,0,trigo
Durango,176,26,2013,8,D0,150,trigo
Michoacán de Ocampo,632,586,2013,8,D0,46,trigo
Nuevo León,14936,12456,2013,8,NPS,2480,trigo
Oaxaca,691,691,2013,8,NPS,0,trigo
Puebla,137,65,2013,8,NPS,72,trigo
Sonora,15,15,2013,8,D0,0,trigo
Tamaulipas,1200,1200,2013,8,NPS,0,trigo
Veracruz de Ignacio de la Llave,68,60,2013,8,NPS,8,trigo
Coahuila de Zaragoza,176,26,2013,8,NPS,150,trigo
Baja California,7033,3716,2013,9,D1,3317,trigo
Chiapas,31,31,2013,9,NPS,0,trigo
Chihuahua,207,207,2013,9,NPS,0,trigo
Durango,176,26,2013,9,NPS,150,trigo
Michoacán de Ocampo,632,586,2013,9,NPS,46,trigo
Nuevo León,14936,12456,2013,9,NPS,2480,trigo
Oaxaca,691,691,2013,9,NPS,0,trigo
Puebla,137,129,2013,9,NPS,8,trigo
Sonora,15,15,2013,9,NPS,0,trigo
Tamaulipas,1200,1200,2013,9,NPS,0,trigo
Veracruz de Ignacio de la Llave,68,68,2013,9,NPS,0,trigo
Coahuila de Zaragoza,176,26,2013,9,NPS,150,trigo
Baja California,7033,3716,2013,12,NPS,3317,trigo
Chiapas,31,31,2013,12,NPS,0,trigo
Chihuahua,207,207,2013,12,NPS,0,trigo
Durango,176,26,2013,12,NPS,150,trigo
Michoacán de Ocampo,632,586,2013,12,NPS,46,trigo
Nuevo León,14936,12456,2013,12,NPS,2480,trigo
Oaxaca,691,691,2013,12,NPS,0,trigo
Puebla,137,129,2013,12,NPS,8,trigo
Sonora,15,15,2013,12,NPS,0,trigo
Tamaulipas,1200,1200,2013,12,NPS,0,trigo
Veracruz de Ignacio de la Llave,68,68,2013,12,NPS,0,trigo
Coahuila de Zaragoza,176,26,2013,12,NPS,150,trigo
Oaxaca,667,50,2014,3,NPS,617,trigo
Puebla,137,25,2014,3,NPS,112,trigo
Chiapas,27,14,2014,4,NPS,13,trigo
Chihuahua,273,119,2014,4,NPS,154,trigo
Michoacán de Ocampo,3777,73,2014,4,NPS,3704,trigo
Nuevo León,11007,2797,2014,4,NPS,8210,trigo
Oaxaca,667,547,2014,4,NPS,120,trigo
Puebla,137,65,2014,4,NPS,72,trigo
San Luis Potosí,10,10,2014,4,NPS,0,trigo
Tamaulipas,845,620,2014,4,NPS,225,trigo
Chiapas,27,27,2014,5,NPS,0,trigo
Chihuahua,273,273,2014,5,D0,0,trigo
Michoacán de Ocampo,3777,440,2014,5,NPS,3337,trigo
Nuevo León,11007,10589,2014,5,NPS,418,trigo
Oaxaca,667,667,2014,5,NPS,0,trigo
Puebla,137,129,2014,5,NPS,8,trigo
San Luis Potosí,10,10,2014,5,NPS,0,trigo
Tamaulipas,845,620,2014,5,NPS,225,trigo
Coahuila de Zaragoza,142,142,2014,6,NPS,0,trigo
Chiapas,27,27,2014,6,NPS,0,trigo
Chihuahua,273,273,2014,6,D0,0,trigo
Durango,124,124,2014,6,D0,0,trigo
Michoacán de Ocampo,3777,540,2014,6,NPS,3237,trigo
Nuevo León,11007,10667,2014,6,D0,340,trigo
Oaxaca,667,667,2014,6,NPS,0,trigo
Puebla,139,129,2014,6,NPS,10,trigo
San Luis Potosí,10,10,2014,6,NPS,0,trigo
Tamaulipas,845,665,2014,6,NPS,180,trigo
Veracruz de Ignacio de la Llave,125,39,2014,6,NPS,86,trigo
Coahuila de Zaragoza,124,124,2014,6,NPS,0,trigo
Baja California,2811,5,2014,7,D3,2806,trigo
Coahuila de Zaragoza,142,142,2014,7,NPS,0,trigo
Chiapas,27,27,2014,7,NPS,0,trigo
Chihuahua,273,273,2014,7,D0,0,trigo
Durango,124,124,2014,7,D0,0,trigo
Michoacán de Ocampo,3777,3772,2014,7,NPS,5,trigo
Nuevo León,11007,10887,2014,7,D0,120,trigo
Oaxaca,667,667,2014,7,NPS,0,trigo
Puebla,139,129,2014,7,NPS,10,trigo
San Luis Potosí,10,10,2014,7,NPS,0,trigo
Tamaulipas,845,665,2014,7,NPS,180,trigo
Veracruz de Ignacio de la Llave,125,85,2014,7,NPS,40,trigo
Coahuila de Zaragoza,124,124,2014,7,NPS,0,trigo
Baja California,2811,5,2014,8,D3,2806,trigo
Coahuila de Zaragoza,142,142,2014,8,NPS,0,trigo
Chiapas,27,27,2014,8,NPS,0,trigo
Chihuahua,273,273,2014,8,D0,0,trigo
Durango,124,124,2014,8,NPS,0,trigo
Michoacán de Ocampo,3777,3777,2014,8,D0,0,trigo
Nuevo León,11007,10887,2014,8,D0,120,trigo
Oaxaca,667,667,2014,8,NPS,0,trigo
Puebla,139,131,2014,8,NPS,8,trigo
San Luis Potosí,10,10,2014,8,NPS,0,trigo
Tamaulipas,845,665,2014,8,D0,180,trigo
Veracruz de Ignacio de la Llave,125,125,2014,8,NPS,0,trigo
Coahuila de Zaragoza,124,124,2014,8,NPS,0,trigo
Baja California,2811,5,2014,9,D3,2806,trigo
Coahuila de Zaragoza,142,142,2014,9,NPS,0,trigo
Chiapas,27,27,2014,9,NPS,0,trigo
Chihuahua,273,273,2014,9,NPS,0,trigo
Durango,124,124,2014,9,NPS,0,trigo
Michoacán de Ocampo,3777,3777,2014,9,D0,0,trigo
Nuevo León,11007,10887,2014,9,NPS,120,trigo
Oaxaca,667,667,2014,9,NPS,0,trigo
Puebla,139,139,2014,9,NPS,0,trigo
San Luis Potosí,10,10,2014,9,NPS,0,trigo
Tamaulipas,845,665,2014,9,NPS,180,trigo
Veracruz de Ignacio de la Llave,125,125,2014,9,NPS,0,trigo
Coahuila de Zaragoza,124,124,2014,9,NPS,0,trigo
Baja California,2811,5,2014,12,D3,2806,trigo
Coahuila de Zaragoza,142,142,2014,12,NPS,0,trigo
Chiapas,27,27,2014,12,NPS,0,trigo
Chihuahua,273,273,2014,12,NPS,0,trigo
Durango,124,124,2014,12,NPS,0,trigo
Michoacán de Ocampo,3777,3777,2014,12,NPS,0,trigo
Nuevo León,11007,10887,2014,12,NPS,120,trigo
Oaxaca,667,667,2014,12,NPS,0,trigo
Puebla,139,139,2014,12,NPS,0,trigo
San Luis Potosí,10,10,2014,12,NPS,0,trigo
Tamaulipas,845,665,2014,12,NPS,180,trigo
Veracruz de Ignacio de la Llave,125,125,2014,12,NPS,0,trigo
Coahuila de Zaragoza,124,124,2014,12,NPS,0,trigo
Durango,478,22,2015,3,NPS,456,trigo
Oaxaca,645,266,2015,3,NPS,379,trigo
Coahuila de Zaragoza,478,22,2015,3,NPS,456,trigo
Durango,478,468,2015,4,NPS,10,trigo
Michoacán de Ocampo,1035,80,2015,4,NPS,955,trigo
Nuevo León,16653,4470,2015,4,NPS,12183,trigo
Oaxaca,645,520,2015,4,NPS,125,trigo
Puebla,137,111,2015,4,NPS,26,trigo
Tamaulipas,9222,2460,2015,4,NPS,6762,trigo
Veracruz de Ignacio de la Llave,62,18,2015,4,NPS,44,trigo
Coahuila de Zaragoza,478,468,2015,4,NPS,10,trigo
Chiapas,28,28,2015,5,NPS,0,trigo
Chihuahua,168,168,2015,5,NPS,0,trigo
Durango,478,478,2015,5,NPS,0,trigo
Michoacán de Ocampo,1035,940,2015,5,NPS,95,trigo
Nuevo León,16653,14837,2015,5,NPS,1816,trigo
Oaxaca,645,645,2015,5,NPS,0,trigo
Puebla,137,111,2015,5,NPS,26,trigo
San Luis Potosí,3,3,2015,5,NPS,0,trigo
Tamaulipas,9192,3380,2015,5,NPS,5812,trigo
Veracruz de Ignacio de la Llave,62,46,2015,5,NPS,16,trigo
Coahuila de Zaragoza,478,478,2015,5,NPS,0,trigo
Coahuila de Zaragoza,312,156,2015,6,NPS,156,trigo
Chiapas,28,28,2015,6,NPS,0,trigo
Chihuahua,168,168,2015,6,NPS,0,trigo
Durango,478,478,2015,6,NPS,0,trigo
Michoacán de Ocampo,1035,1022,2015,6,NPS,13,trigo
Nuevo León,16653,15023,2015,6,NPS,1630,trigo
Oaxaca,645,645,2015,6,NPS,0,trigo
Puebla,137,111,2015,6,NPS,26,trigo
San Luis Potosí,3,3,2015,6,NPS,0,trigo
Tamaulipas,9192,3592,2015,6,NPS,5600,trigo
Veracruz de Ignacio de la Llave,62,49,2015,6,NPS,13,trigo
Coahuila de Zaragoza,478,478,2015,6,NPS,0,trigo
Coahuila de Zaragoza,312,312,2015,7,NPS,0,trigo
Chiapas,28,28,2015,7,D0,0,trigo
Chihuahua,168,168,2015,7,NPS,0,trigo
Durango,478,478,2015,7,NPS,0,trigo
Michoacán de Ocampo,1035,1028,2015,7,NPS,7,trigo
Nuevo León,16653,15236,2015,7,NPS,1417,trigo
Oaxaca,645,645,2015,7,NPS,0,trigo
Puebla,137,111,2015,7,NPS,26,trigo
San Luis Potosí,3,3,2015,7,NPS,0,trigo
Tamaulipas,9192,3592,2015,7,NPS,5600,trigo
Veracruz de Ignacio de la Llave,62,54,2015,7,NPS,8,trigo
Coahuila de Zaragoza,478,478,2015,7,NPS,0,trigo
Coahuila de Zaragoza,312,312,2015,8,NPS,0,trigo
Chiapas,28,28,2015,8,D1,0,trigo
Chihuahua,168,168,2015,8,NPS,0,trigo
Durango,478,478,2015,8,NPS,0,trigo
Michoacán de Ocampo,1035,1035,2015,8,D0,0,trigo
Nuevo León,16653,15311,2015,8,NPS,1342,trigo
Oaxaca,645,645,2015,8,NPS,0,trigo
Puebla,137,111,2015,8,NPS,26,trigo
San Luis Potosí,3,3,2015,8,NPS,0,trigo
Tamaulipas,9192,3592,2015,8,NPS,5600,trigo
Veracruz de Ignacio de la Llave,62,54,2015,8,D0,8,trigo
Coahuila de Zaragoza,478,478,2015,8,NPS,0,trigo
Baja California,6650,238,2015,9,D3,6412,trigo
Coahuila de Zaragoza,312,312,2015,9,NPS,0,trigo
Chiapas,28,28,2015,9,D1,0,trigo
Chihuahua,168,168,2015,9,NPS,0,trigo
Durango,478,478,2015,9,NPS,0,trigo
Michoacán de Ocampo,1035,1035,2015,9,D0,0,trigo
Nuevo León,16653,15311,2015,9,NPS,1342,trigo
Oaxaca,645,645,2015,9,NPS,0,trigo
Puebla,137,111,2015,9,NPS,26,trigo
San Luis Potosí,3,3,2015,9,NPS,0,trigo
Tamaulipas,9192,3592,2015,9,NPS,5600,trigo
Veracruz de Ignacio de la Llave,62,62,2015,9,D0,0,trigo
Coahuila de Zaragoza,478,478,2015,9,NPS,0,trigo
Baja California,6650,238,2015,12,D3,6412,trigo
Coahuila de Zaragoza,312,312,2015,12,NPS,0,trigo
Chiapas,28,28,2015,12,NPS,0,trigo
Chihuahua,168,168,2015,12,NPS,0,trigo
Durango,478,478,2015,12,NPS,0,trigo
Michoacán de Ocampo,1035,1035,2015,12,D0,0,trigo
Nuevo León,16653,15311,2015,12,D0,1342,trigo
Oaxaca,645,645,2015,12,NPS,0,trigo
Puebla,137,111,2015,12,NPS,26,trigo
San Luis Potosí,3,3,2015,12,NPS,0,trigo
Tamaulipas,9192,3592,2015,12,NPS,5600,trigo
Veracruz de Ignacio de la Llave,62,62,2015,12,NPS,0,trigo
Coahuila de Zaragoza,478,478,2015,12,NPS,0,trigo
Durango,235,24,2016,3,D0,211,trigo
Nuevo León,19415,100,2016,3,D0,19315,trigo
Oaxaca,685,315,2016,3,NPS,370,trigo
Coahuila de Zaragoza,235,24,2016,3,NPS,211,trigo
Durango,235,116,2016,4,NPS,119,trigo
Nuevo León,19415,9476,2016,4,D0,9939,trigo
Oaxaca,685,561,2016,4,NPS,124,trigo
Puebla,112,52,2016,4,NPS,60,trigo
Tamaulipas,2253,2253,2016,4,NPS,0,trigo
Veracruz de Ignacio de la Llave,73,19,2016,4,D0,54,trigo
Coahuila de Zaragoza,235,116,2016,4,NPS,119,trigo
Chiapas,22,22,2016,5,NPS,0,trigo
Chihuahua,90,90,2016,5,D0,0,trigo
Durango,235,120,2016,5,NPS,115,trigo
Michoacán de Ocampo,947,481,2016,5,D0,466,trigo
Nuevo León,19415,14170,2016,5,NPS,5245,trigo
Oaxaca,685,685,2016,5,NPS,0,trigo
Puebla,112,112,2016,5,NPS,0,trigo
San Luis Potosí,1,1,2016,5,D0,0,trigo
Tamaulipas,2253,2253,2016,5,NPS,0,trigo
Veracruz de Ignacio de la Llave,73,25,2016,5,D0,48,trigo
Coahuila de Zaragoza,235,120,2016,5,NPS,115,trigo
Coahuila de Zaragoza,308,20,2016,6,NPS,288,trigo
Chiapas,22,22,2016,6,D0,0,trigo
Chihuahua,90,90,2016,6,D0,0,trigo
Durango,235,214,2016,6,D0,21,trigo
Michoacán de Ocampo,947,932,2016,6,D0,15,trigo
Nuevo León,19415,17688,2016,6,NPS,1727,trigo
Oaxaca,685,685,2016,6,NPS,0,trigo
Puebla,112,112,2016,6,NPS,0,trigo
San Luis Potosí,1,1,2016,6,D0,0,trigo
Tamaulipas,2253,2253,2016,6,NPS,0,trigo
Veracruz de Ignacio de la Llave,73,50,2016,6,D1,23,trigo
Coahuila de Zaragoza,235,214,2016,6,NPS,21,trigo
Baja California,5579,1703,2016,7,D3,3876,trigo
Coahuila de Zaragoza,308,308,2016,7,NPS,0,trigo
Chiapas,22,22,2016,7,D0,0,trigo
Chihuahua,90,90,2016,7,D0,0,trigo
Durango,235,214,2016,7,D0,21,trigo
Michoacán de Ocampo,947,944,2016,7,D0,3,trigo
Nuevo León,19415,17933,2016,7,D0,1482,trigo
Oaxaca,685,685,2016,7,D0,0,trigo
Puebla,112,112,2016,7,NPS,0,trigo
San Luis Potosí,1,1,2016,7,D0,0,trigo
Tamaulipas,2253,2253,2016,7,NPS,0,trigo
Veracruz de Ignacio de la Llave,73,65,2016,7,D0,8,trigo
Coahuila de Zaragoza,235,214,2016,7,NPS,21,trigo
Baja California,5579,3904,2016,8,D3,1675,trigo
Coahuila de Zaragoza,308,308,2016,8,NPS,0,trigo
Chiapas,22,22,2016,8,D0,0,trigo
Chihuahua,90,90,2016,8,NPS,0,trigo
Durango,235,214,2016,8,NPS,21,trigo
Michoacán de Ocampo,947,947,2016,8,D1,0,trigo
Nuevo León,19415,17933,2016,8,NPS,1482,trigo
Oaxaca,685,685,2016,8,NPS,0,trigo
Puebla,112,112,2016,8,NPS,0,trigo
San Luis Potosí,1,1,2016,8,D1,0,trigo
Tamaulipas,2253,2253,2016,8,D0,0,trigo
Veracruz de Ignacio de la Llave,73,73,2016,8,NPS,0,trigo
Coahuila de Zaragoza,235,214,2016,8,NPS,21,trigo
Baja California,5579,4549,2016,9,D3,1030,trigo
Coahuila de Zaragoza,308,308,2016,9,NPS,0,trigo
Chiapas,22,22,2016,9,NPS,0,trigo
Chihuahua,90,90,2016,9,NPS,0,trigo
Durango,235,214,2016,9,NPS,21,trigo
Michoacán de Ocampo,947,947,2016,9,D1,0,trigo
Nuevo León,19415,17933,2016,9,NPS,1482,trigo
Oaxaca,685,685,2016,9,D0,0,trigo
Puebla,112,112,2016,9,NPS,0,trigo
San Luis Potosí,1,1,2016,9,NPS,0,trigo
Tamaulipas,2253,2253,2016,9,D0,0,trigo
Veracruz de Ignacio de la Llave,73,73,2016,9,NPS,0,trigo
Coahuila de Zaragoza,235,214,2016,9,NPS,21,trigo
Baja California,5579,4549,2016,12,D3,1030,trigo
Coahuila de Zaragoza,308,308,2016,12,NPS,0,trigo
Chiapas,22,22,2016,12,D0,0,trigo
Chihuahua,90,90,2016,12,NPS,0,trigo
Durango,235,214,2016,12,NPS,21,trigo
Michoacán de Ocampo,947,947,2016,12,NPS,0,trigo
Nuevo León,19415,17933,2016,12,NPS,1482,trigo
Oaxaca,685,685,2016,12,D0,0,trigo
Puebla,112,112,2016,12,NPS,0,trigo
San Luis Potosí,1,1,2016,12,NPS,0,trigo
Tamaulipas,2253,2253,2016,12,NPS,0,trigo
Veracruz de Ignacio de la Llave,73,73,2016,12,NPS,0,trigo
Coahuila de Zaragoza,235,214,2016,12,NPS,21,trigo
Durango,670,645,2017,4,NPS,25,trigo
Nuevo León,17474,8664,2017,4,NPS,8810,trigo
Oaxaca,722,596,2017,4,NPS,126,trigo
Puebla,113,113,2017,4,NPS,0,trigo
Tamaulipas,6800,4200,2017,4,NPS,2600,trigo
Veracruz de Ignacio de la Llave,72,19,2017,4,NPS,53,trigo
Chiapas,24,24,2017,5,NPS,0,trigo
Durango,670,645,2017,5,NPS,25,trigo
Michoacán de Ocampo,1008,993,2017,5,D0,15,trigo
Nuevo León,17474,17474,2017,5,NPS,0,trigo
Oaxaca,722,722,2017,5,NPS,0,trigo
Puebla,113,113,2017,5,NPS,0,trigo
Tamaulipas,6800,4200,2017,5,NPS,2600,trigo
Veracruz de Ignacio de la Llave,72,58,2017,5,NPS,14,trigo
Baja California,5687,20,2017,6,D0,5667,trigo
Chiapas,24,24,2017,6,D0,0,trigo
Durango,670,645,2017,6,D0,25,trigo
Michoacán de Ocampo,1008,1000,2017,6,D0,8,trigo
Nuevo León,17474,17474,2017,6,NPS,0,trigo
Oaxaca,722,722,2017,6,NPS,0,trigo
Puebla,113,113,2017,6,NPS,0,trigo
San Luis Potosí,1,1,2017,6,D1,0,trigo
Tamaulipas,6800,4200,2017,6,D0,2600,trigo
Veracruz de Ignacio de la Llave,72,69,2017,6,D0,3,trigo
Baja California,5687,2482,2017,7,D0,3205,trigo
Coahuila de Zaragoza,273,273,2017,7,D0,0,trigo
Chiapas,24,24,2017,7,D0,0,trigo
Durango,670,645,2017,7,D0,25,trigo
Michoacán de Ocampo,1008,1004,2017,7,D1,4,trigo
Nuevo León,17474,17474,2017,7,D0,0,trigo
Oaxaca,722,722,2017,7,NPS,0,trigo
Puebla,113,113,2017,7,NPS,0,trigo
San Luis Potosí,1,1,2017,7,D1,0,trigo
Tamaulipas,6800,4200,2017,7,D0,2600,trigo
Veracruz de Ignacio de la Llave,72,72,2017,7,D0,0,trigo
Baja California,5687,3878,2017,8,D0,1809,trigo
Coahuila de Zaragoza,273,273,2017,8,D0,0,trigo
Chiapas,24,24,2017,8,D0,0,trigo
Durango,670,645,2017,8,NPS,25,trigo
Michoacán de Ocampo,1008,1008,2017,8,NPS,0,trigo
Nuevo León,17474,17474,2017,8,D0,0,trigo
Oaxaca,722,722,2017,8,NPS,0,trigo
Puebla,113,113,2017,8,NPS,0,trigo
San Luis Potosí,1,1,2017,8,D1,0,trigo
Tamaulipas,6800,4200,2017,8,D0,2600,trigo
Veracruz de Ignacio de la Llave,72,72,2017,8,NPS,0,trigo
Baja California,5687,5687,2017,9,D0,0,trigo
Coahuila de Zaragoza,273,273,2017,9,D0,0,trigo
Chiapas,24,24,2017,9,D0,0,trigo
Durango,670,645,2017,9,NPS,25,trigo
Michoacán de Ocampo,1008,1008,2017,9,NPS,0,trigo
Nuevo León,17474,17474,2017,9,D0,0,trigo
Oaxaca,722,722,2017,9,NPS,0,trigo
Puebla,113,113,2017,9,NPS,0,trigo
San Luis Potosí,1,1,2017,9,D0,0,trigo
Tamaulipas,6800,4200,2017,9,D0,2600,trigo
Veracruz de Ignacio de la Llave,72,72,2017,9,NPS,0,trigo
Baja California,5687,5687,2017,12,D1,0,trigo
Coahuila de Zaragoza,273,273,2017,12,NPS,0,trigo
Chiapas,24,24,2017,12,D0,0,trigo
Durango,670,645,2017,12,NPS,25,trigo
Michoacán de Ocampo,1008,1008,2017,12,D0,0,trigo
Nuevo León,17474,17474,2017,12,NPS,0,trigo
Oaxaca,722,722,2017,12,NPS,0,trigo
Puebla,113,113,2017,12,NPS,0,trigo
San Luis Potosí,1,1,2017,12,D0,0,trigo
Tamaulipas,6800,4200,2017,12,D0,2600,trigo
Veracruz de Ignacio de la Llave,72,72,2017,12,NPS,0,trigo
Durango,279,279,2018,4,NPS,0,trigo
Michoacán de Ocampo,221,86,2018,4,D1,135,trigo
Nuevo León,14405,13368,2018,4,D0,1037,trigo
Oaxaca,714,580,2018,4,NPS,134,trigo
Tamaulipas,387,375,2018,4,NPS,12,trigo
Veracruz de Ignacio de la Llave,76,21,2018,4,NPS,55,trigo
Chiapas,24,24,2018,5,NPS,0,trigo
Chihuahua,55,55,2018,5,D0,0,trigo
Durango,279,279,2018,5,NPS,0,trigo
Jalisco,12,12,2018,5,D0,0,trigo
Michoacán de Ocampo,221,212,2018,5,D1,9,trigo
Nuevo León,14405,14394,2018,5,NPS,11,trigo
Oaxaca,714,714,2018,5,NPS,0,trigo
Puebla,34,34,2018,5,NPS,0,trigo
Tamaulipas,387,375,2018,5,NPS,12,trigo
Veracruz de Ignacio de la Llave,76,22,2018,5,NPS,54,trigo
Coahuila de Zaragoza,414,208,2018,6,D0,206,trigo
Chiapas,24,24,2018,6,D0,0,trigo
Chihuahua,55,55,2018,6,D0,0,trigo
Durango,279,279,2018,6,D0,0,trigo
Jalisco,12,12,2018,6,NPS,0,trigo
Michoacán de Ocampo,221,216,2018,6,NPS,5,trigo
Nuevo León,14405,14404,2018,6,NPS,1,trigo
Oaxaca,714,714,2018,6,NPS,0,trigo
Puebla,34,34,2018,6,NPS,0,trigo
Tamaulipas,387,375,2018,6,NPS,12,trigo
Veracruz de Ignacio de la Llave,76,55,2018,6,NPS,21,trigo
Coahuila de Zaragoza,414,414,2018,7,D0,0,trigo
Chiapas,24,24,2018,7,D0,0,trigo
Chihuahua,55,55,2018,7,D0,0,trigo
Durango,279,279,2018,7,D0,0,trigo
Jalisco,12,12,2018,7,NPS,0,trigo
Michoacán de Ocampo,221,216,2018,7,NPS,5,trigo
Nuevo León,14405,14404,2018,7,NPS,1,trigo
Oaxaca,714,714,2018,7,D0,0,trigo
Puebla,34,34,2018,7,NPS,0,trigo
Tamaulipas,387,375,2018,7,NPS,12,trigo
Veracruz de Ignacio de la Llave,76,69,2018,7,D0,7,trigo
Coahuila de Zaragoza,414,414,2018,8,D0,0,trigo
Chiapas,24,24,2018,8,D1,0,trigo
Chihuahua,55,55,2018,8,D0,0,trigo
Durango,279,279,2018,8,D1,0,trigo
Jalisco,12,12,2018,8,D0,0,trigo
Michoacán de Ocampo,221,221,2018,8,NPS,0,trigo
Nuevo León,14405,14404,2018,8,D0,1,trigo
Oaxaca,714,714,2018,8,D0,0,trigo
Puebla,34,34,2018,8,D0,0,trigo
Tamaulipas,387,375,2018,8,D1,12,trigo
Veracruz de Ignacio de la Llave,76,73,2018,8,D1,3,trigo
Coahuila de Zaragoza,414,414,2018,9,NPS,0,trigo
Chiapas,24,24,2018,9,D0,0,trigo
Chihuahua,55,55,2018,9,D0,0,trigo
Durango,279,279,2018,9,NPS,0,trigo
Jalisco,12,12,2018,9,D0,0,trigo
Michoacán de Ocampo,221,221,2018,9,NPS,0,trigo
Nuevo León,14405,14404,2018,9,NPS,1,trigo
Oaxaca,714,714,2018,9,D0,0,trigo
Puebla,34,34,2018,9,D0,0,trigo
Tamaulipas,387,375,2018,9,NPS,12,trigo
Veracruz de Ignacio de la Llave,76,76,2018,9,D1,0,trigo
Coahuila de Zaragoza,414,414,2018,12,NPS,0,trigo
Chiapas,24,24,2018,12,D0,0,trigo
Chihuahua,55,55,2018,12,NPS,0,trigo
Durango,279,279,2018,12,NPS,0,trigo
Jalisco,12,12,2018,12,NPS,0,trigo
Michoacán de Ocampo,221,221,2018,12,NPS,0,trigo
Nuevo León,14405,14404,2018,12,NPS,1,trigo
Oaxaca,714,714,2018,12,NPS,0,trigo
Puebla,34,34,2018,12,NPS,0,trigo
Tamaulipas,387,375,2018,12,NPS,12,trigo
Veracruz de Ignacio de la Llave,76,76,2018,12,NPS,0,trigo
Durango,725,20,2019,2,D0,705,trigo
Durango,725,725,2019,3,D0,0,trigo
Nuevo León,18304,1040,2019,3,NPS,17264,trigo
Durango,725,725,2019,4,D0,0,trigo
Michoacán de Ocampo,123,71,2019,4,D0,52,trigo
Nuevo León,18304,17060,2019,4,D0,1244,trigo
Oaxaca,663,563,2019,4,NPS,100,trigo
Tamaulipas,2060,2000,2019,4,D0,60,trigo
Chiapas,22,22,2019,5,D1,0,trigo
Chihuahua,41,41,2019,5,NPS,0,trigo
Durango,725,725,2019,5,D0,0,trigo
Jalisco,9,9,2019,5,D0,0,trigo
Michoacán de Ocampo,123,118,2019,5,D0,5,trigo
Nuevo León,18304,17878,2019,5,NPS,426,trigo
Oaxaca,663,663,2019,5,D0,0,trigo
Puebla,30,30,2019,5,D0,0,trigo
Tamaulipas,2060,2060,2019,5,D0,0,trigo
Coahuila de Zaragoza,407,211,2019,6,NPS,196,trigo
Chiapas,22,22,2019,6,D0,0,trigo
Chihuahua,41,41,2019,6,NPS,0,trigo
Durango,725,725,2019,6,D0,0,trigo
Jalisco,9,9,2019,6,D0,0,trigo
Michoacán de Ocampo,123,118,2019,6,D0,5,trigo
Nuevo León,18304,17894,2019,6,NPS,410,trigo
Oaxaca,663,663,2019,6,NPS,0,trigo
Puebla,30,30,2019,6,D0,0,trigo
Tamaulipas,2060,2060,2019,6,D0,0,trigo
Veracruz de Ignacio de la Llave,72,23,2019,6,D0,49,trigo
Baja California,2967,1758,2019,7,D0,1209,trigo
Coahuila de Zaragoza,407,407,2019,7,NPS,0,trigo
Chiapas,22,22,2019,7,D0,0,trigo
Chihuahua,41,41,2019,7,D0,0,trigo
Durango,725,725,2019,7,D1,0,trigo
Jalisco,9,9,2019,7,D1,0,trigo
Michoacán de Ocampo,123,121,2019,7,D1,2,trigo
Nuevo León,18304,17894,2019,7,D0,410,trigo
Oaxaca,663,663,2019,7,D0,0,trigo
Puebla,30,30,2019,7,D0,0,trigo
Tamaulipas,2060,2060,2019,7,D0,0,trigo
Veracruz de Ignacio de la Llave,72,57,2019,7,D1,15,trigo
Baja California,2967,1763,2019,8,D0,1204,trigo
Coahuila de Zaragoza,407,407,2019,8,D0,0,trigo
Chiapas,22,22,2019,8,D1,0,trigo
Chihuahua,41,41,2019,8,D0,0,trigo
Durango,725,725,2019,8,D1,0,trigo
Jalisco,9,9,2019,8,D0,0,trigo
Michoacán de Ocampo,123,123,2019,8,D1,0,trigo
Nuevo León,18304,17894,2019,8,D0,410,trigo
Oaxaca,663,663,2019,8,D0,0,trigo
Puebla,30,30,2019,8,NPS,0,trigo
Tamaulipas,2060,2060,2019,8,D0,0,trigo
Veracruz de Ignacio de la Llave,72,72,2019,8,D2,0,trigo
Baja California,2967,2781,2019,9,NPS,186,trigo
Coahuila de Zaragoza,407,407,2019,9,NPS,0,trigo
Chiapas,22,22,2019,9,D1,0,trigo
Chihuahua,41,41,2019,9,D0,0,trigo
Durango,725,725,2019,9,D2,0,trigo
Jalisco,9,9,2019,9,D0,0,trigo
Michoacán de Ocampo,123,123,2019,9,D1,0,trigo
Nuevo León,18304,17894,2019,9,NPS,410,trigo
Oaxaca,663,663,2019,9,D0,0,trigo
Puebla,30,30,2019,9,NPS,0,trigo
Tamaulipas,2060,2060,2019,9,NPS,0,trigo
Veracruz de Ignacio de la Llave,72,72,2019,9,D3,0,trigo
Baja California,2967,2781,2019,12,NPS,186,trigo
Coahuila de Zaragoza,407,407,2019,12,D0,0,trigo
Chiapas,22,22,2019,12,NPS,0,trigo
Chihuahua,41,41,2019,12,NPS,0,trigo
Durango,725,725,2019,12,NPS,0,trigo
Jalisco,9,9,2019,12,NPS,0,trigo
Michoacán de Ocampo,123,123,2019,12,D1,0,trigo
Nuevo León,18304,17894,2019,12,D0,410,trigo
Oaxaca,663,663,2019,12,NPS,0,trigo
Puebla,30,30,2019,12,NPS,0,trigo
Tamaulipas,2060,2060,2019,12,D1,0,trigo
Veracruz de Ignacio de la Llave,72,72,2019,12,D1,0,trigo
Durango,731,36,2020,2,NPS,695,trigo
Durango,750,711,2020,3,NPS,39,trigo
Durango,750,711,2020,4,D0,39,trigo
Nuevo León,9587,7679,2020,4,D1,1908,trigo
Oaxaca,689,562,2020,4,D0,127,trigo
Tamaulipas,5860,56,2020,4,D0,5804,trigo
Chiapas,21,21,2020,5,NPS,0,trigo
Chihuahua,58,58,2020,5,NPS,0,trigo
Durango,750,730,2020,5,D0,20,trigo
Michoacán de Ocampo,10,9,2020,5,D0,1,trigo
Nuevo León,9587,9009,2020,5,NPS,578,trigo
Oaxaca,689,689,2020,5,NPS,0,trigo
Puebla,27,27,2020,5,NPS,0,trigo
Tamaulipas,5860,156,2020,5,D0,5704,trigo
Coahuila de Zaragoza,427,313,2020,6,D1,114,trigo
Chiapas,21,21,2020,6,NPS,0,trigo
Chihuahua,58,58,2020,6,D0,0,trigo
Durango,750,730,2020,6,D1,20,trigo
Michoacán de Ocampo,10,9,2020,6,D1,1,trigo
Nuevo León,9587,9009,2020,6,NPS,578,trigo
Oaxaca,689,689,2020,6,D0,0,trigo
Puebla,27,27,2020,6,D0,0,trigo
Tamaulipas,5860,1592,2020,6,NPS,4268,trigo
Baja California,2466,1793,2020,7,NPS,673,trigo
Coahuila de Zaragoza,427,427,2020,7,D0,0,trigo
Chiapas,21,21,2020,7,NPS,0,trigo
Chihuahua,58,58,2020,7,D0,0,trigo
Durango,750,730,2020,7,D2,20,trigo
Jalisco,4,4,2020,7,D0,0,trigo
Michoacán de Ocampo,10,10,2020,7,D0,0,trigo
Nuevo León,9587,9009,2020,7,NPS,578,trigo
Oaxaca,689,689,2020,7,D0,0,trigo
Puebla,27,27,2020,7,D0,0,trigo
Tamaulipas,5860,1602,2020,7,NPS,4258,trigo
Veracruz de Ignacio de la Llave,72,53,2020,7,NPS,19,trigo
Baja California,2466,1793,2020,8,D0,673,trigo
Coahuila de Zaragoza,427,427,2020,8,D0,0,trigo
Chiapas,21,21,2020,8,NPS,0,trigo
Chihuahua,58,58,2020,8,D0,0,trigo
Durango,750,730,2020,8,D2,20,trigo
Jalisco,4,4,2020,8,D0,0,trigo
Michoacán de Ocampo,10,10,2020,8,D0,0,trigo
Nuevo León,9587,9017,2020,8,NPS,570,trigo
Oaxaca,689,689,2020,8,NPS,0,trigo
Puebla,27,27,2020,8,NPS,0,trigo
Tamaulipas,5860,1602,2020,8,NPS,4258,trigo
Veracruz de Ignacio de la Llave,72,72,2020,8,NPS,0,trigo
Baja California,2466,1888,2020,9,D0,578,trigo
Coahuila de Zaragoza,427,427,2020,9,D0,0,trigo
Chiapas,21,21,2020,9,NPS,0,trigo
Chihuahua,58,58,2020,9,D1,0,trigo
Durango,750,730,2020,9,D1,20,trigo
Jalisco,4,4,2020,9,D0,0,trigo
Michoacán de Ocampo,10,10,2020,9,D1,0,trigo
Nuevo León,9587,9017,2020,9,NPS,570,trigo
Oaxaca,689,689,2020,9,NPS,0,trigo
Puebla,27,27,2020,9,NPS,0,trigo
Tamaulipas,5860,1602,2020,9,NPS,4258,trigo
Veracruz de Ignacio de la Llave,72,72,2020,9,D0,0,trigo
Baja California,2466,1888,2020,12,D0,578,trigo
Coahuila de Zaragoza,427,427,2020,12,D1,0,trigo
Chiapas,21,21,2020,12,NPS,0,trigo
Chihuahua,58,58,2020,12,D2,0,trigo
Durango,750,730,2020,12,D1,20,trigo
Jalisco,4,4,2020,12,D1,0,trigo
Michoacán de Ocampo,10,10,2020,12,D1,0,trigo
Nuevo León,9587,9017,2020,12,D1,570,trigo
Oaxaca,689,689,2020,12,NPS,0,trigo
Puebla,27,27,2020,12,NPS,0,trigo
Tamaulipas,5860,1602,2020,12,D1,4258,trigo
Veracruz de Ignacio de la Llave,72,72,2020,12,D0,0,trigo
San Luis Potosí,3080,500,2004,9,NPS,2580,trigo
Durango,1384,195,2004,10,NPS,1189,trigo
Guanajuato,16366,1170,2004,10,NPS,15196,trigo
Hidalgo,2585,155,2004,10,NPS,2430,trigo
Puebla,3711,627,2004,10,NPS,3084,trigo
San Luis Potosí,3080,1000,2004,10,NPS,2080,trigo
Tlaxcala,36969,4800,2004,10,NPS,32169,trigo
Durango,1384,537,2004,11,NPS,847,trigo
Guanajuato,16366,15841,2004,11,NPS,525,trigo
Hidalgo,2585,2585,2004,11,NPS,0,trigo
Estado de México,18508,5960,2004,11,NPS,12548,trigo
Michoacán de Ocampo,1260,26,2004,11,NPS,1234,trigo
Nuevo León,145,145,2004,11,NPS,0,trigo
Oaxaca,11763,56,2004,11,D0,11707,trigo
Puebla,3711,1920,2004,11,NPS,1791,trigo
San Luis Potosí,3080,2500,2004,11,NPS,580,trigo
Tamaulipas,35,35,2004,11,NPS,0,trigo
Tlaxcala,36969,23128,2004,11,NPS,13841,trigo
Zacatecas,3283,2379,2004,11,NPS,904,trigo
Durango,1384,1381,2005,1,NPS,3,trigo
Guanajuato,16366,16366,2005,1,NPS,0,trigo
Hidalgo,2585,2585,2005,1,D0,0,trigo
Jalisco,5041,3985,2005,1,NPS,1056,trigo
Estado de México,18508,18357,2005,1,NPS,151,trigo
Michoacán de Ocampo,1330,1100,2005,1,NPS,230,trigo
Morelos,559,559,2005,1,NPS,0,trigo
Nuevo León,145,145,2005,1,NPS,0,trigo
Oaxaca,11763,9225,2005,1,D0,2538,trigo
Puebla,3711,2996,2005,1,NPS,715,trigo
Querétaro de Arteaga,418,340,2005,1,NPS,78,trigo
San Luis Potosí,3080,3080,2005,1,NPS,0,trigo
Tamaulipas,35,35,2005,1,D0,0,trigo
Tlaxcala,36969,36928,2005,1,NPS,41,trigo
Veracruz de Ignacio de la Llave,610,570,2005,1,D1,40,trigo
Zacatecas,3283,3228,2005,1,NPS,55,trigo
Durango,1384,1381,2005,2,NPS,3,trigo
Guanajuato,16366,16366,2005,2,NPS,0,trigo
Hidalgo,2585,2585,2005,2,NPS,0,trigo
Jalisco,5041,4225,2005,2,NPS,816,trigo
Estado de México,18508,18460,2005,2,NPS,48,trigo
Michoacán de Ocampo,1330,1214,2005,2,NPS,116,trigo
Morelos,559,559,2005,2,NPS,0,trigo
Nuevo León,145,145,2005,2,NPS,0,trigo
Oaxaca,11763,9310,2005,2,D0,2453,trigo
Puebla,3711,3556,2005,2,NPS,155,trigo
Querétaro de Arteaga,418,340,2005,2,NPS,78,trigo
San Luis Potosí,3080,3080,2005,2,NPS,0,trigo
Tamaulipas,35,35,2005,2,NPS,0,trigo
Tlaxcala,36969,36928,2005,2,NPS,41,trigo
Veracruz de Ignacio de la Llave,610,570,2005,2,D1,40,trigo
Zacatecas,3283,3283,2005,2,NPS,0,trigo
Chiapas,112,112,2005,3,D1,0,trigo
Durango,1384,1381,2005,3,NPS,3,trigo
Guanajuato,16366,16366,2005,3,NPS,0,trigo
Hidalgo,2585,2585,2005,3,NPS,0,trigo
Jalisco,5041,4780,2005,3,NPS,261,trigo
Estado de México,18508,18460,2005,3,NPS,48,trigo
Michoacán de Ocampo,1330,1296,2005,3,NPS,34,trigo
Morelos,559,559,2005,3,NPS,0,trigo
Nuevo León,145,145,2005,3,NPS,0,trigo
Oaxaca,11763,9310,2005,3,NPS,2453,trigo
Puebla,3711,3556,2005,3,NPS,155,trigo
Querétaro de Arteaga,418,340,2005,3,NPS,78,trigo
San Luis Potosí,3080,3080,2005,3,NPS,0,trigo
Tamaulipas,35,35,2005,3,NPS,0,trigo
Tlaxcala,36969,36928,2005,3,NPS,41,trigo
Veracruz de Ignacio de la Llave,610,570,2005,3,D1,40,trigo
Zacatecas,3283,3283,2005,3,NPS,0,trigo
Tlaxcala,39783,23,2005,9,D0,39760,trigo
Veracruz de Ignacio de la Llave,570,469,2005,9,NPS,101,trigo
Chihuahua,40,40,2005,10,NPS,0,trigo
Durango,2500,15,2005,10,NPS,2485,trigo
Puebla,3536,516,2005,10,NPS,3020,trigo
Tlaxcala,39783,23,2005,10,NPS,39760,trigo
Veracruz de Ignacio de la Llave,570,469,2005,10,NPS,101,trigo
Zacatecas,6864,24,2005,10,NPS,6840,trigo
Chihuahua,40,40,2005,11,NPS,0,trigo
Durango,2500,1393,2005,11,NPS,1107,trigo
Guanajuato,17044,12532,2005,11,NPS,4512,trigo
Hidalgo,3116,1065,2005,11,NPS,2051,trigo
Estado de México,15606,1055,2005,11,D0,14551,trigo
Nuevo León,1327,84,2005,11,NPS,1243,trigo
Oaxaca,14469,52,2005,11,NPS,14417,trigo
Puebla,3536,2040,2005,11,NPS,1496,trigo
San Luis Potosí,3500,800,2005,11,NPS,2700,trigo
Tlaxcala,39687,21155,2005,11,D0,18532,trigo
Veracruz de Ignacio de la Llave,570,469,2005,11,NPS,101,trigo
Zacatecas,6864,3987,2005,11,NPS,2877,trigo
Chihuahua,40,40,2006,1,D1,0,trigo
Durango,2500,1669,2006,1,D0,831,trigo
Guanajuato,17044,13107,2006,1,D0,3937,trigo
Hidalgo,3116,2826,2006,1,D0,290,trigo
Jalisco,3273,3027,2006,1,D1,246,trigo
Estado de México,15606,14374,2006,1,D0,1232,trigo
Michoacán de Ocampo,744,249,2006,1,D1,495,trigo
Morelos,516,492,2006,1,D0,24,trigo
Nuevo León,1327,84,2006,1,D0,1243,trigo
Oaxaca,14469,8652,2006,1,D0,5817,trigo
Puebla,3536,3358,2006,1,D0,178,trigo
Querétaro de Arteaga,468,468,2006,1,D0,0,trigo
San Luis Potosí,3500,800,2006,1,D0,2700,trigo
Tlaxcala,39687,39687,2006,1,D0,0,trigo
Veracruz de Ignacio de la Llave,570,519,2006,1,NPS,51,trigo
Zacatecas,6864,5703,2006,1,D0,1161,trigo
Chihuahua,40,40,2006,2,D2,0,trigo
Durango,2500,1669,2006,2,D1,831,trigo
Guanajuato,17044,13107,2006,2,D1,3937,trigo
Hidalgo,3116,2826,2006,2,D0,290,trigo
Jalisco,3273,3273,2006,2,D1,0,trigo
Estado de México,15606,15251,2006,2,D1,355,trigo
Michoacán de Ocampo,854,854,2006,2,D1,0,trigo
Morelos,516,492,2006,2,D1,24,trigo
Nuevo León,1327,84,2006,2,D0,1243,trigo
Oaxaca,14469,8652,2006,2,D0,5817,trigo
Puebla,3536,3358,2006,2,D0,178,trigo
Querétaro de Arteaga,468,468,2006,2,D1,0,trigo
San Luis Potosí,3500,800,2006,2,D0,2700,trigo
Tlaxcala,39687,39687,2006,2,D1,0,trigo
Veracruz de Ignacio de la Llave,570,519,2006,2,NPS,51,trigo
Zacatecas,6864,5703,2006,2,D1,1161,trigo
Baja California,85,82,2006,7,NPS,3,trigo
Baja California,85,82,2006,8,D0,3,trigo
Zacatecas,13379,28,2006,8,NPS,13351,trigo
Baja California,85,82,2006,9,D0,3,trigo
Zacatecas,13889,69,2006,9,NPS,13820,trigo
Baja California,85,82,2006,10,D1,3,trigo
Durango,3455,605,2006,10,NPS,2850,trigo
Hidalgo,2266,278,2006,10,NPS,1988,trigo
Estado de México,16840,26,2006,10,NPS,16814,trigo
Nuevo León,259,250,2006,10,NPS,9,trigo
Oaxaca,14508,30,2006,10,NPS,14478,trigo
Puebla,3460,941,2006,10,NPS,2519,trigo
Tlaxcala,41832,3733,2006,10,NPS,38099,trigo
Zacatecas,13889,218,2006,10,NPS,13671,trigo
Baja California,85,82,2006,11,D2,3,trigo
Chihuahua,4,4,2006,11,NPS,0,trigo
Durango,3455,2608,2006,11,NPS,847,trigo
Guanajuato,18138,15464,2006,11,NPS,2674,trigo
Hidalgo,2396,2116,2006,11,D1,280,trigo
Jalisco,3573,1590,2006,11,NPS,1983,trigo
Estado de México,16844,2984,2006,11,NPS,13860,trigo
Michoacán de Ocampo,826,86,2006,11,NPS,740,trigo
Nuevo León,259,259,2006,11,NPS,0,trigo
Oaxaca,14508,2469,2006,11,NPS,12039,trigo
Puebla,3460,2486,2006,11,NPS,974,trigo
San Luis Potosí,2200,1000,2006,11,NPS,1200,trigo
Tamaulipas,18,18,2006,11,NPS,0,trigo
Tlaxcala,41832,33970,2006,11,D1,7862,trigo
Zacatecas,13889,9598,2006,11,NPS,4291,trigo
Baja California,85,85,2007,1,D2,0,trigo
Chihuahua,4,4,2007,1,NPS,0,trigo
Durango,3455,3431,2007,1,NPS,24,trigo
Guanajuato,18138,17638,2007,1,NPS,500,trigo
Hidalgo,2396,2364,2007,1,D1,32,trigo
Jalisco,3573,1857,2007,1,NPS,1716,trigo
Estado de México,16844,16840,2007,1,NPS,4,trigo
Michoacán de Ocampo,826,584,2007,1,NPS,242,trigo
Morelos,661,661,2007,1,NPS,0,trigo
Nuevo León,259,259,2007,1,NPS,0,trigo
Oaxaca,14508,10817,2007,1,NPS,3691,trigo
Puebla,3460,3379,2007,1,NPS,81,trigo
Querétaro de Arteaga,359,92,2007,1,NPS,267,trigo
San Luis Potosí,2200,2200,2007,1,NPS,0,trigo
Tamaulipas,18,18,2007,1,NPS,0,trigo
Tlaxcala,41832,41683,2007,1,NPS,149,trigo
Veracruz de Ignacio de la Llave,40,40,2007,1,NPS,0,trigo
Zacatecas,13889,13667,2007,1,NPS,222,trigo
Baja California,85,85,2007,2,D1,0,trigo
Chihuahua,4,4,2007,2,NPS,0,trigo
Durango,3455,3431,2007,2,NPS,24,trigo
Guanajuato,18138,17638,2007,2,NPS,500,trigo
Hidalgo,2396,2364,2007,2,NPS,32,trigo
Jalisco,3921,2421,2007,2,NPS,1500,trigo
Estado de México,16844,16840,2007,2,NPS,4,trigo
Michoacán de Ocampo,826,756,2007,2,NPS,70,trigo
Morelos,661,661,2007,2,NPS,0,trigo
Nuevo León,259,259,2007,2,NPS,0,trigo
Oaxaca,14508,10817,2007,2,NPS,3691,trigo
Puebla,3460,3429,2007,2,NPS,31,trigo
Querétaro de Arteaga,359,92,2007,2,NPS,267,trigo
San Luis Potosí,2200,2200,2007,2,NPS,0,trigo
Tamaulipas,18,18,2007,2,NPS,0,trigo
Tlaxcala,41832,41683,2007,2,D1,149,trigo
Veracruz de Ignacio de la Llave,600,600,2007,2,NPS,0,trigo
Zacatecas,13889,13667,2007,2,NPS,222,trigo
Baja California,85,85,2007,3,D1,0,trigo
Chiapas,84,84,2007,3,D0,0,trigo
Chihuahua,4,4,2007,3,NPS,0,trigo
Durango,3455,3431,2007,3,NPS,24,trigo
Guanajuato,18138,17638,2007,3,NPS,500,trigo
Hidalgo,2396,2364,2007,3,NPS,32,trigo
Jalisco,3921,2421,2007,3,D0,1500,trigo
Estado de México,16844,16840,2007,3,NPS,4,trigo
Michoacán de Ocampo,826,826,2007,3,NPS,0,trigo
Morelos,661,661,2007,3,NPS,0,trigo
Nuevo León,259,259,2007,3,NPS,0,trigo
Oaxaca,14508,10817,2007,3,NPS,3691,trigo
Puebla,3460,3429,2007,3,NPS,31,trigo
Querétaro de Arteaga,359,92,2007,3,NPS,267,trigo
San Luis Potosí,2200,2200,2007,3,NPS,0,trigo
Tamaulipas,18,18,2007,3,NPS,0,trigo
Tlaxcala,41832,41683,2007,3,D0,149,trigo
Veracruz de Ignacio de la Llave,600,600,2007,3,NPS,0,trigo
Zacatecas,13889,13667,2007,3,NPS,222,trigo
Chihuahua,370,60,2007,10,D1,310,trigo
Hidalgo,2495,140,2007,10,NPS,2355,trigo
Michoacán de Ocampo,1086,8,2007,10,NPS,1078,trigo
Nuevo León,200,150,2007,10,NPS,50,trigo
Oaxaca,13826,20,2007,10,NPS,13806,trigo
Puebla,3314,513,2007,10,NPS,2801,trigo
Tlaxcala,44242,3995,2007,10,NPS,40247,trigo
Zacatecas,33317,7051,2007,10,NPS,26266,trigo
Coahuila de Zaragoza,20,20,2007,11,D0,0,trigo
Chihuahua,370,370,2007,11,D0,0,trigo
Durango,7063,6605,2007,11,D0,458,trigo
Guanajuato,16108,12579,2007,11,NPS,3529,trigo
Hidalgo,2495,2249,2007,11,NPS,246,trigo
Jalisco,6216,4790,2007,11,D2,1426,trigo
Estado de México,11924,687,2007,11,NPS,11237,trigo
Michoacán de Ocampo,1086,30,2007,11,NPS,1056,trigo
Nuevo León,200,200,2007,11,D0,0,trigo
Oaxaca,13826,2861,2007,11,NPS,10965,trigo
Puebla,3314,2302,2007,11,NPS,1012,trigo
San Luis Potosí,2400,1900,2007,11,NPS,500,trigo
Tamaulipas,20,20,2007,11,D0,0,trigo
Tlaxcala,43978,10064,2007,11,NPS,33914,trigo
Veracruz de Ignacio de la Llave,560,453,2007,11,NPS,107,trigo
Zacatecas,33317,28667,2007,11,NPS,4650,trigo
Coahuila de Zaragoza,20,20,2008,1,D0,0,trigo
Chihuahua,370,370,2008,1,D0,0,trigo
Durango,7063,6651,2008,1,D1,412,trigo
Guanajuato,16108,14514,2008,1,D1,1594,trigo
Hidalgo,2495,2456,2008,1,NPS,39,trigo
Jalisco,6216,4815,2008,1,D2,1401,trigo
Estado de México,11924,11924,2008,1,NPS,0,trigo
Michoacán de Ocampo,1086,905,2008,1,D1,181,trigo
Morelos,372,372,2008,1,NPS,0,trigo
Nuevo León,200,200,2008,1,NPS,0,trigo
Oaxaca,13826,12852,2008,1,NPS,974,trigo
Puebla,3314,3134,2008,1,NPS,180,trigo
Querétaro de Arteaga,372,372,2008,1,NPS,0,trigo
San Luis Potosí,2400,1900,2008,1,NPS,500,trigo
Tamaulipas,20,20,2008,1,D0,0,trigo
Tlaxcala,75019,42197,2008,1,NPS,32822,trigo
Veracruz de Ignacio de la Llave,560,553,2008,1,NPS,7,trigo
Zacatecas,33317,32362,2008,1,NPS,955,trigo
Coahuila de Zaragoza,20,20,2008,2,D1,0,trigo
Chihuahua,370,370,2008,2,D0,0,trigo
Durango,7063,6651,2008,2,D1,412,trigo
Guanajuato,16108,14514,2008,2,D1,1594,trigo
Hidalgo,2495,2456,2008,2,NPS,39,trigo
Jalisco,6216,5111,2008,2,D2,1105,trigo
Estado de México,11924,11924,2008,2,NPS,0,trigo
Michoacán de Ocampo,1141,991,2008,2,D2,150,trigo
Morelos,372,372,2008,2,D0,0,trigo
Nuevo León,200,200,2008,2,D0,0,trigo
Oaxaca,13826,13826,2008,2,NPS,0,trigo
Puebla,3314,3246,2008,2,NPS,68,trigo
Querétaro de Arteaga,372,372,2008,2,NPS,0,trigo
San Luis Potosí,2400,1900,2008,2,NPS,500,trigo
Tamaulipas,20,20,2008,2,NPS,0,trigo
Tlaxcala,75019,45012,2008,2,NPS,30007,trigo
Veracruz de Ignacio de la Llave,560,553,2008,2,NPS,7,trigo
Zacatecas,33317,32362,2008,2,D1,955,trigo
Coahuila de Zaragoza,20,20,2008,3,D1,0,trigo
Chiapas,84,84,2008,3,NPS,0,trigo
Chihuahua,370,370,2008,3,D0,0,trigo
Durango,7063,6651,2008,3,D1,412,trigo
Guanajuato,16108,14514,2008,3,D1,1594,trigo
Hidalgo,2495,2456,2008,3,NPS,39,trigo
Jalisco,6216,5111,2008,3,D1,1105,trigo
Estado de México,11924,11924,2008,3,D0,0,trigo
Michoacán de Ocampo,1141,1141,2008,3,D1,0,trigo
Morelos,372,372,2008,3,D0,0,trigo
Nuevo León,200,200,2008,3,D1,0,trigo
Oaxaca,13826,13826,2008,3,D0,0,trigo
Puebla,3314,3246,2008,3,NPS,68,trigo
Querétaro de Arteaga,372,372,2008,3,D0,0,trigo
San Luis Potosí,2400,1900,2008,3,NPS,500,trigo
Tamaulipas,20,20,2008,3,NPS,0,trigo
Tlaxcala,75019,75013,2008,3,NPS,6,trigo
Veracruz de Ignacio de la Llave,560,553,2008,3,NPS,7,trigo
Zacatecas,33317,32362,2008,3,D1,955,trigo
Zacatecas,46861,26,2008,8,NPS,46835,trigo
Veracruz de Ignacio de la Llave,585,130,2008,9,D0,455,trigo
Zacatecas,46861,41,2008,9,NPS,46820,trigo
Durango,22246,425,2008,10,NPS,21821,trigo
Hidalgo,2304,122,2008,10,NPS,2182,trigo
Jalisco,3752,1000,2008,10,NPS,2752,trigo
Estado de México,12194,100,2008,10,D0,12094,trigo
Michoacán de Ocampo,920,100,2008,10,D1,820,trigo
Puebla,3958,1460,2008,10,NPS,2498,trigo
Tlaxcala,45857,11353,2008,10,D1,34504,trigo
Veracruz de Ignacio de la Llave,585,130,2008,10,NPS,455,trigo
Zacatecas,46891,7257,2008,10,NPS,39634,trigo
Chihuahua,398,112,2008,11,NPS,286,trigo
Durango,22246,17208,2008,11,NPS,5038,trigo
Guanajuato,15176,6862,2008,11,D0,8314,trigo
Hidalgo,2304,1124,2008,11,NPS,1180,trigo
Jalisco,3752,3500,2008,11,D0,252,trigo
Estado de México,12409,1497,2008,11,D1,10912,trigo
Michoacán de Ocampo,920,144,2008,11,D1,776,trigo
Morelos,453,36,2008,11,D0,417,trigo
Nuevo León,210,210,2008,11,NPS,0,trigo
Oaxaca,13870,3001,2008,11,NPS,10869,trigo
Puebla,3958,2808,2008,11,NPS,1150,trigo
San Luis Potosí,3000,500,2008,11,NPS,2500,trigo
Tlaxcala,45857,38842,2008,11,D1,7015,trigo
Veracruz de Ignacio de la Llave,585,585,2008,11,NPS,0,trigo
Zacatecas,46891,34900,2008,11,NPS,11991,trigo
Chihuahua,398,398,2009,1,NPS,0,trigo
Durango,22246,21212,2009,1,NPS,1034,trigo
Guanajuato,15176,12112,2009,1,D0,3064,trigo
Hidalgo,2304,2284,2009,1,NPS,20,trigo
Jalisco,3752,3540,2009,1,NPS,212,trigo
Estado de México,12569,12569,2009,1,D1,0,trigo
Michoacán de Ocampo,920,217,2009,1,D1,703,trigo
Morelos,453,403,2009,1,D0,50,trigo
Nuevo León,210,210,2009,1,NPS,0,trigo
Oaxaca,13870,13236,2009,1,NPS,634,trigo
Puebla,3958,3921,2009,1,NPS,37,trigo
Querétaro de Arteaga,355,348,2009,1,NPS,7,trigo
San Luis Potosí,3000,2500,2009,1,NPS,500,trigo
Tamaulipas,10,8,2009,1,NPS,2,trigo
Tlaxcala,45857,45453,2009,1,D1,404,trigo
Veracruz de Ignacio de la Llave,585,585,2009,1,D0,0,trigo
Zacatecas,46891,45623,2009,1,NPS,1268,trigo
Chihuahua,398,398,2009,2,NPS,0,trigo
Durango,22246,21212,2009,2,NPS,1034,trigo
Guanajuato,15176,13232,2009,2,D0,1944,trigo
Hidalgo,2304,2284,2009,2,NPS,20,trigo
Jalisco,3752,3704,2009,2,NPS,48,trigo
Estado de México,12569,12569,2009,2,D1,0,trigo
Michoacán de Ocampo,920,380,2009,2,D1,540,trigo
Morelos,453,403,2009,2,D0,50,trigo
Nuevo León,210,210,2009,2,NPS,0,trigo
Oaxaca,13870,13870,2009,2,NPS,0,trigo
Puebla,3958,3921,2009,2,NPS,37,trigo
Querétaro de Arteaga,355,348,2009,2,NPS,7,trigo
San Luis Potosí,3000,2500,2009,2,NPS,500,trigo
Tamaulipas,10,8,2009,2,NPS,2,trigo
Tlaxcala,45857,45453,2009,2,D1,404,trigo
Veracruz de Ignacio de la Llave,585,585,2009,2,D0,0,trigo
Zacatecas,46891,45623,2009,2,NPS,1268,trigo
Chiapas,88,88,2009,3,D0,0,trigo
Chihuahua,398,398,2009,3,NPS,0,trigo
Durango,22246,21212,2009,3,NPS,1034,trigo
Guanajuato,15176,13746,2009,3,D0,1430,trigo
Hidalgo,2304,2284,2009,3,NPS,20,trigo
Jalisco,3752,3752,2009,3,D1,0,trigo
Estado de México,12569,12569,2009,3,D1,0,trigo
Michoacán de Ocampo,920,920,2009,3,D1,0,trigo
Morelos,453,453,2009,3,D0,0,trigo
Nuevo León,210,210,2009,3,NPS,0,trigo
Oaxaca,13870,13870,2009,3,NPS,0,trigo
Puebla,3958,3921,2009,3,NPS,37,trigo
Querétaro de Arteaga,355,348,2009,3,NPS,7,trigo
San Luis Potosí,3000,2500,2009,3,NPS,500,trigo
Tamaulipas,10,8,2009,3,NPS,2,trigo
Tlaxcala,45857,45453,2009,3,D1,404,trigo
Veracruz de Ignacio de la Llave,585,585,2009,3,NPS,0,trigo
Zacatecas,46891,45623,2009,3,NPS,1268,trigo
Hidalgo,2248,25,2009,8,D1,2223,trigo
Veracruz de Ignacio de la Llave,800,682,2009,9,NPS,118,trigo
Chihuahua,220,150,2009,10,NPS,70,trigo
Durango,12439,445,2009,10,NPS,11994,trigo
Hidalgo,2248,50,2009,10,NPS,2198,trigo
Jalisco,6294,1005,2009,10,D1,5289,trigo
Estado de México,11896,2,2009,10,D1,11894,trigo
Nuevo León,1130,65,2009,10,D0,1065,trigo
Puebla,3709,20,2009,10,NPS,3689,trigo
Tlaxcala,45035,7150,2009,10,D1,37885,trigo
Veracruz de Ignacio de la Llave,800,682,2009,10,NPS,118,trigo
Zacatecas,26167,120,2009,10,NPS,26047,trigo
Chihuahua,220,220,2009,11,NPS,0,trigo
Durango,12455,3347,2009,11,NPS,9108,trigo
Guanajuato,12610,3806,2009,11,D1,8804,trigo
Hidalgo,2248,512,2009,11,NPS,1736,trigo
Jalisco,6294,1495,2009,11,D1,4799,trigo
Estado de México,11886,2779,2009,11,D1,9107,trigo
Nuevo León,1130,1130,2009,11,NPS,0,trigo
Puebla,3709,1370,2009,11,D0,2339,trigo
San Luis Potosí,1500,300,2009,11,NPS,1200,trigo
Tlaxcala,45035,26705,2009,11,D0,18330,trigo
Veracruz de Ignacio de la Llave,800,722,2009,11,NPS,78,trigo
Zacatecas,26167,5976,2009,11,NPS,20191,trigo
Chihuahua,220,220,2010,1,NPS,0,trigo
Durango,12575,11114,2010,1,NPS,1461,trigo
Guanajuato,12610,4212,2010,1,D1,8398,trigo
Hidalgo,2248,775,2010,1,NPS,1473,trigo
Jalisco,6294,2016,2010,1,D2,4278,trigo
Estado de México,11886,11695,2010,1,D0,191,trigo
Michoacán de Ocampo,1010,90,2010,1,D1,920,trigo
Morelos,383,383,2010,1,D0,0,trigo
Nuevo León,1130,1130,2010,1,NPS,0,trigo
Oaxaca,14366,2740,2010,1,NPS,11626,trigo
Puebla,3709,2148,2010,1,NPS,1561,trigo
Querétaro de Arteaga,317,317,2010,1,NPS,0,trigo
San Luis Potosí,1500,300,2010,1,NPS,1200,trigo
Tlaxcala,45035,44971,2010,1,NPS,64,trigo
Veracruz de Ignacio de la Llave,800,752,2010,1,NPS,48,trigo
Zacatecas,26167,19640,2010,1,NPS,6527,trigo
Chihuahua,220,220,2010,2,NPS,0,trigo
Durango,12575,11114,2010,2,NPS,1461,trigo
Guanajuato,12610,4212,2010,2,NPS,8398,trigo
Hidalgo,2248,775,2010,2,NPS,1473,trigo
Jalisco,6294,2018,2010,2,NPS,4276,trigo
Estado de México,11886,11835,2010,2,NPS,51,trigo
Michoacán de Ocampo,1010,353,2010,2,NPS,657,trigo
Morelos,383,383,2010,2,D0,0,trigo
Nuevo León,1130,1130,2010,2,NPS,0,trigo
Oaxaca,14366,10010,2010,2,NPS,4356,trigo
Puebla,3709,2148,2010,2,NPS,1561,trigo
Querétaro de Arteaga,317,317,2010,2,NPS,0,trigo
San Luis Potosí,1500,300,2010,2,NPS,1200,trigo
Tlaxcala,45035,44971,2010,2,NPS,64,trigo
Veracruz de Ignacio de la Llave,800,752,2010,2,NPS,48,trigo
Zacatecas,26167,19640,2010,2,NPS,6527,trigo
Zacatecas,8797,274,2010,9,NPS,8523,trigo
Guanajuato,12859,1500,2010,10,NPS,11359,trigo
Hidalgo,1935,2,2010,10,NPS,1933,trigo
Jalisco,3568,520,2010,10,NPS,3048,trigo
Nuevo León,261,12,2010,10,NPS,249,trigo
Tlaxcala,41320,8022,2010,10,NPS,33298,trigo
Zacatecas,8797,274,2010,10,NPS,8523,trigo
Durango,8942,2122,2010,11,NPS,6820,trigo
Guanajuato,12859,4316,2010,11,NPS,8543,trigo
Hidalgo,1940,615,2010,11,NPS,1325,trigo
Jalisco,3568,1740,2010,11,NPS,1828,trigo
Estado de México,9760,439,2010,11,NPS,9321,trigo
Michoacán de Ocampo,1093,75,2010,11,NPS,1018,trigo
Nuevo León,261,12,2010,11,NPS,249,trigo
Puebla,2919,2018,2010,11,NPS,901,trigo
San Luis Potosí,800,400,2010,11,NPS,400,trigo
Tamaulipas,28,3,2010,11,NPS,25,trigo
Tlaxcala,41320,28717,2010,11,NPS,12603,trigo
Veracruz de Ignacio de la Llave,800,30,2010,11,NPS,770,trigo
Zacatecas,8842,7095,2010,11,NPS,1747,trigo
Chihuahua,50,50,2011,1,D0,0,trigo
Durango,8942,8621,2011,1,NPS,321,trigo
Guanajuato,12859,6729,2011,1,D0,6130,trigo
Hidalgo,1940,780,2011,1,NPS,1160,trigo
Jalisco,3568,2099,2011,1,D0,1469,trigo
Estado de México,9760,8952,2011,1,NPS,808,trigo
Michoacán de Ocampo,1093,357,2011,1,D0,736,trigo
Morelos,382,382,2011,1,NPS,0,trigo
Nuevo León,261,261,2011,1,NPS,0,trigo
Oaxaca,14665,8602,2011,1,NPS,6063,trigo
Puebla,2919,2889,2011,1,NPS,30,trigo
Querétaro de Arteaga,195,48,2011,1,NPS,147,trigo
San Luis Potosí,800,630,2011,1,NPS,170,trigo
Tamaulipas,28,3,2011,1,NPS,25,trigo
Tlaxcala,41320,40934,2011,1,NPS,386,trigo
Veracruz de Ignacio de la Llave,800,300,2011,1,NPS,500,trigo
Zacatecas,8842,8616,2011,1,NPS,226,trigo
Chihuahua,50,50,2011,2,D0,0,trigo
Durango,8942,8621,2011,2,NPS,321,trigo
Guanajuato,12859,6729,2011,2,NPS,6130,trigo
Hidalgo,1940,780,2011,2,NPS,1160,trigo
Jalisco,3568,2128,2011,2,D0,1440,trigo
Estado de México,9760,9716,2011,2,NPS,44,trigo
Michoacán de Ocampo,1093,1013,2011,2,D0,80,trigo
Morelos,382,382,2011,2,NPS,0,trigo
Nuevo León,261,261,2011,2,NPS,0,trigo
Oaxaca,14665,10092,2011,2,NPS,4573,trigo
Puebla,2919,2909,2011,2,NPS,10,trigo
Querétaro de Arteaga,195,48,2011,2,NPS,147,trigo
San Luis Potosí,800,630,2011,2,NPS,170,trigo
Tamaulipas,28,3,2011,2,NPS,25,trigo
Tlaxcala,41320,40934,2011,2,NPS,386,trigo
Veracruz de Ignacio de la Llave,800,800,2011,2,NPS,0,trigo
Zacatecas,8842,8667,2011,2,NPS,175,trigo
Chiapas,80,80,2011,3,NPS,0,trigo
Chihuahua,50,50,2011,3,D3,0,trigo
Durango,8942,8621,2011,3,D1,321,trigo
Guanajuato,12859,6729,2011,3,D0,6130,trigo
Hidalgo,1940,780,2011,3,D0,1160,trigo
Jalisco,3568,2128,2011,3,D0,1440,trigo
Estado de México,9760,9716,2011,3,D0,44,trigo
Michoacán de Ocampo,1093,1013,2011,3,D0,80,trigo
Morelos,382,382,2011,3,D0,0,trigo
Nuevo León,261,261,2011,3,D2,0,trigo
Oaxaca,14665,10092,2011,3,D1,4573,trigo
Puebla,2919,2909,2011,3,NPS,10,trigo
Querétaro de Arteaga,195,48,2011,3,D0,147,trigo
San Luis Potosí,800,630,2011,3,D0,170,trigo
Tamaulipas,28,3,2011,3,D0,25,trigo
Tlaxcala,41320,40934,2011,3,D0,386,trigo
Veracruz de Ignacio de la Llave,800,800,2011,3,NPS,0,trigo
Zacatecas,8842,8667,2011,3,D1,175,trigo
Chihuahua,507,100,2011,10,D3,407,trigo
Durango,3216,48,2011,10,D3,3168,trigo
Hidalgo,1454,9,2011,10,D0,1445,trigo
Estado de México,10299,50,2011,10,D0,10249,trigo
Tlaxcala,32133,697,2011,10,NPS,31436,trigo
Veracruz de Ignacio de la Llave,150,60,2011,10,D0,90,trigo
Chihuahua,507,100,2011,11,D3,407,trigo
Durango,3216,337,2011,11,D3,2879,trigo
Guanajuato,12440,126,2011,11,D2,12314,trigo
Hidalgo,1454,52,2011,11,D0,1402,trigo
Jalisco,6147,31,2011,11,D2,6116,trigo
Estado de México,10299,653,2011,11,D0,9646,trigo
Michoacán de Ocampo,453,63,2011,11,D0,390,trigo
Nuevo León,225,30,2011,11,D3,195,trigo
Oaxaca,14373,10,2011,11,NPS,14363,trigo
Puebla,4172,1566,2011,11,NPS,2606,trigo
Querétaro de Arteaga,153,130,2011,11,D2,23,trigo
San Luis Potosí,520,90,2011,11,D2,430,trigo
Tlaxcala,32133,4766,2011,11,NPS,27367,trigo
Veracruz de Ignacio de la Llave,150,100,2011,11,D0,50,trigo
Zacatecas,9127,2721,2011,11,D3,6406,trigo
Chihuahua,507,100,2012,1,D3,407,trigo
Durango,3216,922,2012,1,D3,2294,trigo
Guanajuato,12440,3039,2012,1,D2,9401,trigo
Hidalgo,1454,1271,2012,1,D0,183,trigo
Jalisco,6147,185,2012,1,D1,5962,trigo
Estado de México,10299,9849,2012,1,D0,450,trigo
Michoacán de Ocampo,453,427,2012,1,D1,26,trigo
Morelos,375,357,2012,1,NPS,18,trigo
Nuevo León,225,30,2012,1,D2,195,trigo
Oaxaca,14373,14323,2012,1,NPS,50,trigo
Puebla,4172,3332,2012,1,NPS,840,trigo
Querétaro de Arteaga,153,130,2012,1,D1,23,trigo
San Luis Potosí,520,90,2012,1,D0,430,trigo
Tlaxcala,32133,16814,2012,1,NPS,15319,trigo
Veracruz de Ignacio de la Llave,150,150,2012,1,NPS,0,trigo
Zacatecas,9127,6165,2012,1,D3,2962,trigo
Chiapas,85,85,2012,2,NPS,0,trigo
Chihuahua,507,100,2012,2,D3,407,trigo
Durango,3216,922,2012,2,D3,2294,trigo
Guanajuato,12440,3039,2012,2,D1,9401,trigo
Hidalgo,1454,1271,2012,2,NPS,183,trigo
Jalisco,6147,185,2012,2,NPS,5962,trigo
Estado de México,10299,9849,2012,2,NPS,450,trigo
Michoacán de Ocampo,453,453,2012,2,NPS,0,trigo
Morelos,375,375,2012,2,NPS,0,trigo
Nuevo León,225,30,2012,2,D2,195,trigo
Oaxaca,14373,14373,2012,2,NPS,0,trigo
Puebla,4172,3818,2012,2,NPS,354,trigo
Querétaro de Arteaga,153,130,2012,2,D1,23,trigo
San Luis Potosí,520,90,2012,2,NPS,430,trigo
Tlaxcala,32133,16814,2012,2,NPS,15319,trigo
Veracruz de Ignacio de la Llave,150,150,2012,2,NPS,0,trigo
Zacatecas,9128,6165,2012,2,D1,2963,trigo
Chiapas,85,85,2012,3,NPS,0,trigo
Chihuahua,507,100,2012,3,D2,407,trigo
Durango,3216,922,2012,3,D3,2294,trigo
Guanajuato,12440,3039,2012,3,D1,9401,trigo
Hidalgo,1454,1271,2012,3,NPS,183,trigo
Jalisco,6147,185,2012,3,NPS,5962,trigo
Estado de México,10299,9849,2012,3,NPS,450,trigo
Michoacán de Ocampo,453,453,2012,3,NPS,0,trigo
Morelos,375,375,2012,3,NPS,0,trigo
Nuevo León,225,30,2012,3,D0,195,trigo
Oaxaca,14373,14373,2012,3,NPS,0,trigo
Puebla,4172,3818,2012,3,NPS,354,trigo
Querétaro de Arteaga,153,130,2012,3,NPS,23,trigo
San Luis Potosí,520,90,2012,3,NPS,430,trigo
Tlaxcala,32133,16814,2012,3,NPS,15319,trigo
Veracruz de Ignacio de la Llave,150,150,2012,3,NPS,0,trigo
Zacatecas,9128,6166,2012,3,D2,2962,trigo
Chihuahua,350,350,2012,10,D0,0,trigo
Durango,1778,76,2012,10,D0,1702,trigo
Guanajuato,13182,2865,2012,10,NPS,10317,trigo
Hidalgo,1446,40,2012,10,NPS,1406,trigo
Jalisco,6511,1596,2012,10,NPS,4915,trigo
Nuevo León,334,70,2012,10,NPS,264,trigo
Tamaulipas,50,50,2012,10,NPS,0,trigo
Tlaxcala,29260,3495,2012,10,NPS,25765,trigo
Chihuahua,350,350,2012,11,NPS,0,trigo
Durango,1778,361,2012,11,NPS,1417,trigo
Guanajuato,13182,10032,2012,11,NPS,3150,trigo
Hidalgo,1446,643,2012,11,NPS,803,trigo
Jalisco,6511,5066,2012,11,NPS,1445,trigo
Estado de México,9676,1636,2012,11,NPS,8040,trigo
Michoacán de Ocampo,493,17,2012,11,NPS,476,trigo
Nuevo León,334,334,2012,11,D0,0,trigo
Oaxaca,14112,15,2012,11,NPS,14097,trigo
Puebla,2980,1760,2012,11,NPS,1220,trigo
San Luis Potosí,120,38,2012,11,D0,82,trigo
Tamaulipas,50,50,2012,11,NPS,0,trigo
Tlaxcala,29260,15948,2012,11,NPS,13312,trigo
Veracruz de Ignacio de la Llave,905,445,2012,11,NPS,460,trigo
Zacatecas,3020,1685,2012,11,D0,1335,trigo
Coahuila de Zaragoza,30,30,2012,11,D1,0,trigo
Chiapas,79,79,2013,1,NPS,0,trigo
Chihuahua,350,350,2013,1,NPS,0,trigo
Durango,1778,1387,2013,1,NPS,391,trigo
Guanajuato,13182,12583,2013,1,NPS,599,trigo
Hidalgo,1446,1446,2013,1,NPS,0,trigo
Jalisco,6511,6423,2013,1,NPS,88,trigo
Estado de México,9676,9676,2013,1,NPS,0,trigo
Michoacán de Ocampo,493,443,2013,1,NPS,50,trigo
Nuevo León,334,334,2013,1,D1,0,trigo
Oaxaca,14112,14052,2013,1,NPS,60,trigo
Puebla,2980,2628,2013,1,NPS,352,trigo
Querétaro de Arteaga,66,39,2013,1,NPS,27,trigo
San Luis Potosí,120,38,2013,1,NPS,82,trigo
Tamaulipas,50,50,2013,1,D0,0,trigo
Tlaxcala,29260,29260,2013,1,NPS,0,trigo
Veracruz de Ignacio de la Llave,905,892,2013,1,NPS,13,trigo
Zacatecas,3020,2995,2013,1,NPS,25,trigo
Coahuila de Zaragoza,30,30,2013,1,D1,0,trigo
Chiapas,79,79,2013,2,NPS,0,trigo
Chihuahua,350,350,2013,2,NPS,0,trigo
Durango,1778,1387,2013,2,NPS,391,trigo
Guanajuato,13182,12763,2013,2,D0,419,trigo
Hidalgo,1446,1446,2013,2,NPS,0,trigo
Jalisco,6511,6511,2013,2,NPS,0,trigo
Estado de México,9676,9676,2013,2,NPS,0,trigo
Michoacán de Ocampo,493,493,2013,2,D0,0,trigo
Morelos,380,380,2013,2,NPS,0,trigo
Nuevo León,334,334,2013,2,D0,0,trigo
Oaxaca,14112,14112,2013,2,NPS,0,trigo
Puebla,2980,2980,2013,2,NPS,0,trigo
Querétaro de Arteaga,66,39,2013,2,NPS,27,trigo
San Luis Potosí,120,38,2013,2,NPS,82,trigo
Tamaulipas,50,50,2013,2,NPS,0,trigo
Tlaxcala,29260,29260,2013,2,D0,0,trigo
Veracruz de Ignacio de la Llave,905,892,2013,2,NPS,13,trigo
Zacatecas,3020,2995,2013,2,NPS,25,trigo
Coahuila de Zaragoza,30,30,2013,2,D1,0,trigo
Chiapas,79,79,2013,3,NPS,0,trigo
Chihuahua,350,350,2013,3,NPS,0,trigo
Durango,1778,1387,2013,3,NPS,391,trigo
Guanajuato,13182,12763,2013,3,D0,419,trigo
Hidalgo,1446,1446,2013,3,D0,0,trigo
Jalisco,6511,6511,2013,3,NPS,0,trigo
Estado de México,9676,9676,2013,3,NPS,0,trigo
Michoacán de Ocampo,493,493,2013,3,NPS,0,trigo
Morelos,380,380,2013,3,NPS,0,trigo
Nuevo León,334,334,2013,3,NPS,0,trigo
Oaxaca,14112,14112,2013,3,NPS,0,trigo
Puebla,2980,2980,2013,3,NPS,0,trigo
Querétaro de Arteaga,66,39,2013,3,NPS,27,trigo
San Luis Potosí,120,38,2013,3,NPS,82,trigo
Tamaulipas,50,50,2013,3,NPS,0,trigo
Tlaxcala,29260,29260,2013,3,D0,0,trigo
Veracruz de Ignacio de la Llave,905,892,2013,3,NPS,13,trigo
Zacatecas,3020,2995,2013,3,NPS,25,trigo
Coahuila de Zaragoza,30,30,2013,3,D1,0,trigo
Nuevo León,397,10,2013,9,NPS,387,trigo
Puebla,4067,3,2013,9,NPS,4064,trigo
Guanajuato,13147,1890,2013,10,NPS,11257,trigo
Hidalgo,1686,40,2013,10,NPS,1646,trigo
Jalisco,6304,5042,2013,10,NPS,1262,trigo
Estado de México,9073,20,2013,10,NPS,9053,trigo
Nuevo León,397,120,2013,10,NPS,277,trigo
Puebla,4067,490,2013,10,NPS,3577,trigo
Tamaulipas,40,20,2013,10,NPS,20,trigo
Tlaxcala,33806,8579,2013,10,NPS,25227,trigo
Veracruz de Ignacio de la Llave,571,149,2013,10,NPS,422,trigo
Durango,952,290,2013,11,NPS,662,trigo
Guanajuato,13147,6297,2013,11,NPS,6850,trigo
Hidalgo,1686,993,2013,11,NPS,693,trigo
Jalisco,6304,5747,2013,11,NPS,557,trigo
Estado de México,9073,1644,2013,11,NPS,7429,trigo
Michoacán de Ocampo,1100,3,2013,11,NPS,1097,trigo
Nuevo León,397,370,2013,11,NPS,27,trigo
Oaxaca,14141,4760,2013,11,NPS,9381,trigo
Puebla,4067,1729,2013,11,NPS,2338,trigo
Tamaulipas,40,20,2013,11,NPS,20,trigo
Tlaxcala,33806,19749,2013,11,NPS,14057,trigo
Veracruz de Ignacio de la Llave,571,427,2013,11,NPS,144,trigo
Zacatecas,7324,1050,2013,11,NPS,6274,trigo
Durango,952,937,2014,1,NPS,15,trigo
Guanajuato,13147,13147,2014,1,NPS,0,trigo
Hidalgo,1686,1686,2014,1,NPS,0,trigo
Jalisco,6299,6204,2014,1,NPS,95,trigo
Estado de México,9073,9073,2014,1,NPS,0,trigo
Michoacán de Ocampo,1100,749,2014,1,NPS,351,trigo
Morelos,370,360,2014,1,NPS,10,trigo
Nuevo León,397,370,2014,1,NPS,27,trigo
Oaxaca,14141,8424,2014,1,NPS,5717,trigo
Puebla,4067,3732,2014,1,NPS,335,trigo
Querétaro de Arteaga,176,176,2014,1,NPS,0,trigo
San Luis Potosí,1000,400,2014,1,NPS,600,trigo
Tamaulipas,40,20,2014,1,NPS,20,trigo
Tlaxcala,33806,33666,2014,1,NPS,140,trigo
Veracruz de Ignacio de la Llave,571,571,2014,1,NPS,0,trigo
Zacatecas,7324,7309,2014,1,NPS,15,trigo
Coahuila de Zaragoza,50,50,2014,1,NPS,0,trigo
Chiapas,71,71,2014,2,NPS,0,trigo
Durango,952,937,2014,2,NPS,15,trigo
Guanajuato,13147,13147,2014,2,NPS,0,trigo
Hidalgo,1686,1686,2014,2,NPS,0,trigo
Jalisco,6299,6299,2014,2,NPS,0,trigo
Estado de México,9073,9073,2014,2,NPS,0,trigo
Michoacán de Ocampo,1100,1100,2014,2,NPS,0,trigo
Morelos,370,370,2014,2,NPS,0,trigo
Nuevo León,397,370,2014,2,NPS,27,trigo
Oaxaca,14141,8511,2014,2,NPS,5630,trigo
Puebla,4067,3943,2014,2,NPS,124,trigo
Querétaro de Arteaga,176,176,2014,2,NPS,0,trigo
San Luis Potosí,1000,400,2014,2,NPS,600,trigo
Tamaulipas,40,20,2014,2,NPS,20,trigo
Tlaxcala,33806,33756,2014,2,NPS,50,trigo
Veracruz de Ignacio de la Llave,571,571,2014,2,NPS,0,trigo
Zacatecas,7324,7316,2014,2,NPS,8,trigo
Coahuila de Zaragoza,50,50,2014,2,NPS,0,trigo
Chiapas,71,71,2014,3,NPS,0,trigo
Durango,952,937,2014,3,NPS,15,trigo
Guanajuato,13147,13147,2014,3,NPS,0,trigo
Hidalgo,1686,1686,2014,3,NPS,0,trigo
Jalisco,6299,6299,2014,3,NPS,0,trigo
Estado de México,9073,9073,2014,3,NPS,0,trigo
Michoacán de Ocampo,1100,1100,2014,3,NPS,0,trigo
Morelos,370,370,2014,3,NPS,0,trigo
Nuevo León,397,370,2014,3,NPS,27,trigo
Oaxaca,14141,8511,2014,3,NPS,5630,trigo
Puebla,4067,3943,2014,3,NPS,124,trigo
Querétaro de Arteaga,176,176,2014,3,NPS,0,trigo
San Luis Potosí,1000,400,2014,3,NPS,600,trigo
Tamaulipas,40,20,2014,3,NPS,20,trigo
Tlaxcala,33806,33756,2014,3,NPS,50,trigo
Veracruz de Ignacio de la Llave,571,571,2014,3,NPS,0,trigo
Zacatecas,7324,7316,2014,3,NPS,8,trigo
Coahuila de Zaragoza,50,50,2014,3,NPS,0,trigo
Tlaxcala,33381,10,2014,9,NPS,33371,trigo
Durango,2409,276,2014,10,NPS,2133,trigo
Guanajuato,11787,4475,2014,10,NPS,7312,trigo
Puebla,3954,818,2014,10,NPS,3136,trigo
Tlaxcala,33381,10001,2014,10,NPS,23380,trigo
Veracruz de Ignacio de la Llave,646,62,2014,10,NPS,584,trigo
Chihuahua,430,150,2014,11,NPS,280,trigo
Durango,2409,276,2014,11,NPS,2133,trigo
Guanajuato,11787,7586,2014,11,NPS,4201,trigo
Hidalgo,1336,292,2014,11,NPS,1044,trigo
Estado de México,9102,2871,2014,11,NPS,6231,trigo
Michoacán de Ocampo,1052,5,2014,11,NPS,1047,trigo
Nuevo León,295,203,2014,11,NPS,92,trigo
Puebla,3954,1943,2014,11,NPS,2011,trigo
San Luis Potosí,350,200,2014,11,NPS,150,trigo
Tamaulipas,50,50,2014,11,NPS,0,trigo
Tlaxcala,33381,23832,2014,11,NPS,9549,trigo
Veracruz de Ignacio de la Llave,646,555,2014,11,NPS,91,trigo
Zacatecas,16688,4068,2014,11,NPS,12620,trigo
Chiapas,73,73,2015,1,NPS,0,trigo
Chihuahua,430,430,2015,1,NPS,0,trigo
Durango,2409,2409,2015,1,NPS,0,trigo
Guanajuato,11787,10229,2015,1,NPS,1558,trigo
Hidalgo,1336,1336,2015,1,NPS,0,trigo
Jalisco,3256,3222,2015,1,NPS,34,trigo
Estado de México,9102,8984,2015,1,NPS,118,trigo
Michoacán de Ocampo,1052,698,2015,1,D0,354,trigo
Morelos,360,360,2015,1,NPS,0,trigo
Nuevo León,295,295,2015,1,NPS,0,trigo
Oaxaca,11576,10690,2015,1,NPS,886,trigo
Puebla,3954,3110,2015,1,NPS,844,trigo
Querétaro de Arteaga,312,312,2015,1,NPS,0,trigo
San Luis Potosí,350,300,2015,1,NPS,50,trigo
Tamaulipas,50,50,2015,1,NPS,0,trigo
Tlaxcala,33381,33251,2015,1,NPS,130,trigo
Veracruz de Ignacio de la Llave,646,646,2015,1,NPS,0,trigo
Zacatecas,16688,16488,2015,1,NPS,200,trigo
Chiapas,73,73,2015,2,NPS,0,trigo
Chihuahua,430,430,2015,2,NPS,0,trigo
Durango,2409,2409,2015,2,NPS,0,trigo
Guanajuato,11787,11779,2015,2,NPS,8,trigo
Hidalgo,1336,1336,2015,2,NPS,0,trigo
Jalisco,3256,3256,2015,2,NPS,0,trigo
Estado de México,9102,9102,2015,2,NPS,0,trigo
Michoacán de Ocampo,1052,1052,2015,2,D0,0,trigo
Morelos,360,360,2015,2,NPS,0,trigo
Nuevo León,295,295,2015,2,NPS,0,trigo
Oaxaca,11576,11468,2015,2,NPS,108,trigo
Puebla,3954,3940,2015,2,NPS,14,trigo
Querétaro de Arteaga,312,312,2015,2,NPS,0,trigo
San Luis Potosí,350,300,2015,2,NPS,50,trigo
Tamaulipas,50,50,2015,2,NPS,0,trigo
Tlaxcala,33381,33251,2015,2,NPS,130,trigo
Veracruz de Ignacio de la Llave,646,646,2015,2,NPS,0,trigo
Zacatecas,16688,16688,2015,2,NPS,0,trigo
Chiapas,73,73,2015,3,NPS,0,trigo
Chihuahua,430,430,2015,3,NPS,0,trigo
Durango,2409,2409,2015,3,NPS,0,trigo
Guanajuato,11787,11779,2015,3,NPS,8,trigo
Hidalgo,1336,1336,2015,3,NPS,0,trigo
Jalisco,3256,3256,2015,3,NPS,0,trigo
Estado de México,9102,9102,2015,3,NPS,0,trigo
Michoacán de Ocampo,1052,1052,2015,3,NPS,0,trigo
Morelos,360,360,2015,3,NPS,0,trigo
Nuevo León,295,295,2015,3,NPS,0,trigo
Oaxaca,11576,11468,2015,3,NPS,108,trigo
Puebla,3954,3940,2015,3,NPS,14,trigo
Querétaro de Arteaga,312,312,2015,3,NPS,0,trigo
San Luis Potosí,350,300,2015,3,NPS,50,trigo
Tamaulipas,50,50,2015,3,NPS,0,trigo
Tlaxcala,33381,33251,2015,3,NPS,130,trigo
Veracruz de Ignacio de la Llave,646,646,2015,3,NPS,0,trigo
Zacatecas,16688,16688,2015,3,NPS,0,trigo
Veracruz de Ignacio de la Llave,657,68,2015,8,D0,589,trigo
Nuevo León,160,160,2015,9,NPS,0,trigo
Veracruz de Ignacio de la Llave,657,162,2015,9,D0,495,trigo
Guanajuato,13310,118,2015,10,NPS,13192,trigo
Hidalgo,1620,136,2015,10,NPS,1484,trigo
Estado de México,8210,383,2015,10,NPS,7827,trigo
Nuevo León,160,160,2015,10,NPS,0,trigo
Puebla,3314,495,2015,10,NPS,2819,trigo
Tlaxcala,28043,14040,2015,10,NPS,14003,trigo
Veracruz de Ignacio de la Llave,657,552,2015,10,D0,105,trigo
Chihuahua,360,360,2015,11,NPS,0,trigo
Durango,6344,179,2015,11,NPS,6165,trigo
Guanajuato,13310,7564,2015,11,NPS,5746,trigo
Hidalgo,1620,1170,2015,11,NPS,450,trigo
Jalisco,1956,31,2015,11,NPS,1925,trigo
Estado de México,8210,2562,2015,11,NPS,5648,trigo
Michoacán de Ocampo,960,7,2015,11,D0,953,trigo
Nuevo León,160,160,2015,11,NPS,0,trigo
Puebla,3314,1214,2015,11,NPS,2100,trigo
San Luis Potosí,550,300,2015,11,NPS,250,trigo
Tamaulipas,40,40,2015,11,NPS,0,trigo
Tlaxcala,28043,26923,2015,11,NPS,1120,trigo
Veracruz de Ignacio de la Llave,657,657,2015,11,NPS,0,trigo
Zacatecas,18043,4800,2015,11,NPS,13243,trigo
Chiapas,61,61,2016,1,NPS,0,trigo
Chihuahua,360,360,2016,1,NPS,0,trigo
Durango,6344,5287,2016,1,D0,1057,trigo
Guanajuato,13310,12950,2016,1,NPS,360,trigo
Hidalgo,1620,1598,2016,1,NPS,22,trigo
Jalisco,1956,112,2016,1,NPS,1844,trigo
Estado de México,8210,8210,2016,1,NPS,0,trigo
Michoacán de Ocampo,960,766,2016,1,NPS,194,trigo
Morelos,290,201,2016,1,NPS,89,trigo
Nuevo León,160,160,2016,1,D0,0,trigo
Oaxaca,11921,11072,2016,1,NPS,849,trigo
Puebla,3314,2097,2016,1,NPS,1217,trigo
Querétaro de Arteaga,345,345,2016,1,D0,0,trigo
San Luis Potosí,550,442,2016,1,NPS,108,trigo
Tamaulipas,40,40,2016,1,NPS,0,trigo
Tlaxcala,28043,28043,2016,1,NPS,0,trigo
Veracruz de Ignacio de la Llave,657,657,2016,1,NPS,0,trigo
Zacatecas,18043,17712,2016,1,NPS,331,trigo
Chiapas,61,61,2016,2,NPS,0,trigo
Chihuahua,360,360,2016,2,NPS,0,trigo
Durango,6344,6344,2016,2,D0,0,trigo
Guanajuato,13310,13310,2016,2,NPS,0,trigo
Hidalgo,1620,1598,2016,2,NPS,22,trigo
Jalisco,1956,1956,2016,2,NPS,0,trigo
Estado de México,8210,8210,2016,2,NPS,0,trigo
Michoacán de Ocampo,960,960,2016,2,D0,0,trigo
Morelos,290,290,2016,2,NPS,0,trigo
Nuevo León,160,160,2016,2,D1,0,trigo
Oaxaca,11921,11124,2016,2,NPS,797,trigo
Puebla,3314,2378,2016,2,NPS,936,trigo
Querétaro de Arteaga,345,345,2016,2,NPS,0,trigo
San Luis Potosí,550,442,2016,2,NPS,108,trigo
Tamaulipas,40,40,2016,2,NPS,0,trigo
Tlaxcala,28043,28043,2016,2,NPS,0,trigo
Veracruz de Ignacio de la Llave,657,657,2016,2,D0,0,trigo
Zacatecas,18043,17949,2016,2,NPS,94,trigo
Chiapas,61,61,2016,3,NPS,0,trigo
Chihuahua,360,360,2016,3,D0,0,trigo
Durango,6344,6344,2016,3,D0,0,trigo
Guanajuato,13310,13310,2016,3,NPS,0,trigo
Hidalgo,1620,1598,2016,3,D0,22,trigo
Jalisco,1956,1956,2016,3,NPS,0,trigo
Estado de México,8210,8210,2016,3,NPS,0,trigo
Michoacán de Ocampo,960,960,2016,3,D0,0,trigo
Morelos,290,290,2016,3,NPS,0,trigo
Nuevo León,160,160,2016,3,D0,0,trigo
Oaxaca,11921,11124,2016,3,NPS,797,trigo
Puebla,3314,2378,2016,3,NPS,936,trigo
Querétaro de Arteaga,345,345,2016,3,NPS,0,trigo
San Luis Potosí,550,442,2016,3,NPS,108,trigo
Tamaulipas,40,40,2016,3,NPS,0,trigo
Tlaxcala,28043,28043,2016,3,NPS,0,trigo
Veracruz de Ignacio de la Llave,657,657,2016,3,D0,0,trigo
Zacatecas,18043,17949,2016,3,NPS,94,trigo
Guanajuato,12764,120,2016,10,NPS,12644,trigo
Hidalgo,809,156,2016,10,NPS,653,trigo
Estado de México,4937,206,2016,10,NPS,4731,trigo
Nuevo León,600,480,2016,10,NPS,120,trigo
Tlaxcala,19225,8475,2016,10,NPS,10750,trigo
Veracruz de Ignacio de la Llave,574,229,2016,10,NPS,345,trigo
Chihuahua,200,200,2016,11,NPS,0,trigo
Durango,12100,805,2016,11,NPS,11295,trigo
Guanajuato,12764,5940,2016,11,NPS,6824,trigo
Hidalgo,809,603,2016,11,NPS,206,trigo
Jalisco,2152,28,2016,11,NPS,2124,trigo
Estado de México,4937,1340,2016,11,NPS,3597,trigo
Michoacán de Ocampo,550,79,2016,11,NPS,471,trigo
Nuevo León,600,480,2016,11,NPS,120,trigo
Puebla,2443,1424,2016,11,NPS,1019,trigo
Querétaro de Arteaga,119,100,2016,11,NPS,19,trigo
Tlaxcala,19225,19225,2016,11,NPS,0,trigo
Veracruz de Ignacio de la Llave,574,574,2016,11,NPS,0,trigo
Zacatecas,11714,1100,2016,11,NPS,10614,trigo
Chiapas,53,53,2017,1,NPS,0,trigo
Chihuahua,200,200,2017,1,NPS,0,trigo
Durango,12100,12100,2017,1,NPS,0,trigo
Guanajuato,12764,11724,2017,1,NPS,1040,trigo
Hidalgo,809,799,2017,1,NPS,10,trigo
Jalisco,2152,2041,2017,1,NPS,111,trigo
Estado de México,4937,4937,2017,1,NPS,0,trigo
Michoacán de Ocampo,550,514,2017,1,NPS,36,trigo
Morelos,283,283,2017,1,NPS,0,trigo
Nuevo León,600,535,2017,1,NPS,65,trigo
Oaxaca,11896,11833,2017,1,D0,63,trigo
Puebla,2443,1918,2017,1,NPS,525,trigo
Querétaro de Arteaga,119,119,2017,1,D0,0,trigo
San Luis Potosí,945,708,2017,1,NPS,237,trigo
Tamaulipas,30,30,2017,1,NPS,0,trigo
Tlaxcala,19225,19225,2017,1,NPS,0,trigo
Veracruz de Ignacio de la Llave,574,574,2017,1,NPS,0,trigo
Zacatecas,11714,11551,2017,1,NPS,163,trigo
Chiapas,53,53,2017,2,NPS,0,trigo
Chihuahua,200,200,2017,2,NPS,0,trigo
Durango,12100,12100,2017,2,NPS,0,trigo
Guanajuato,12764,12764,2017,2,D0,0,trigo
Hidalgo,809,799,2017,2,NPS,10,trigo
Jalisco,2152,2152,2017,2,D0,0,trigo
Estado de México,4937,4937,2017,2,NPS,0,trigo
Michoacán de Ocampo,550,550,2017,2,D0,0,trigo
Morelos,283,283,2017,2,D0,0,trigo
Nuevo León,600,535,2017,2,NPS,65,trigo
Oaxaca,11896,11896,2017,2,D0,0,trigo
Puebla,2443,2443,2017,2,NPS,0,trigo
Querétaro de Arteaga,119,119,2017,2,D0,0,trigo
San Luis Potosí,945,708,2017,2,D0,237,trigo
Tamaulipas,30,30,2017,2,D0,0,trigo
Tlaxcala,19225,19225,2017,2,NPS,0,trigo
Veracruz de Ignacio de la Llave,574,574,2017,2,NPS,0,trigo
Zacatecas,11714,11551,2017,2,D0,163,trigo
Chiapas,53,53,2017,3,NPS,0,trigo
Chihuahua,200,200,2017,3,NPS,0,trigo
Durango,12100,12100,2017,3,NPS,0,trigo
Guanajuato,12764,12764,2017,3,D0,0,trigo
Hidalgo,809,799,2017,3,NPS,10,trigo
Jalisco,2152,2152,2017,3,D0,0,trigo
Estado de México,4937,4937,2017,3,NPS,0,trigo
Michoacán de Ocampo,550,550,2017,3,D0,0,trigo
Morelos,283,283,2017,3,D0,0,trigo
Nuevo León,600,535,2017,3,NPS,65,trigo
Oaxaca,11896,11896,2017,3,D0,0,trigo
Puebla,2443,2443,2017,3,NPS,0,trigo
Querétaro de Arteaga,119,119,2017,3,D0,0,trigo
San Luis Potosí,945,708,2017,3,D0,237,trigo
Tamaulipas,30,30,2017,3,NPS,0,trigo
Tlaxcala,19225,19225,2017,3,NPS,0,trigo
Veracruz de Ignacio de la Llave,574,574,2017,3,NPS,0,trigo
Zacatecas,11714,11551,2017,3,D0,163,trigo
Hidalgo,1652,111,2017,10,NPS,1541,trigo
Estado de México,5087,1085,2017,10,NPS,4002,trigo
Puebla,2549,240,2017,10,NPS,2309,trigo
Tamaulipas,20,20,2017,10,NPS,0,trigo
Tlaxcala,19675,10239,2017,10,NPS,9436,trigo
Veracruz de Ignacio de la Llave,534,188,2017,10,NPS,346,trigo
Chihuahua,170,170,2017,11,NPS,0,trigo
Durango,4844,305,2017,11,NPS,4539,trigo
Guanajuato,13094,7484,2017,11,NPS,5610,trigo
Hidalgo,1652,1353,2017,11,NPS,299,trigo
Estado de México,5087,1937,2017,11,NPS,3150,trigo
Puebla,2549,1111,2017,11,NPS,1438,trigo
San Luis Potosí,250,43,2017,11,D0,207,trigo
Tamaulipas,20,20,2017,11,D0,0,trigo
Tlaxcala,19675,18475,2017,11,NPS,1200,trigo
Veracruz de Ignacio de la Llave,534,391,2017,11,NPS,143,trigo
Zacatecas,7816,1071,2017,11,NPS,6745,trigo
Chiapas,48,48,2018,1,D0,0,trigo
Chihuahua,170,170,2018,1,NPS,0,trigo
Durango,4844,4844,2018,1,NPS,0,trigo
Guanajuato,13094,13094,2018,1,D1,0,trigo
Hidalgo,1652,1652,2018,1,NPS,0,trigo
Jalisco,1872,1846,2018,1,D0,26,trigo
Estado de México,5087,5087,2018,1,D0,0,trigo
Michoacán de Ocampo,429,429,2018,1,D0,0,trigo
Morelos,131,41,2018,1,D0,90,trigo
Nuevo León,35,35,2018,1,NPS,0,trigo
Oaxaca,11590,11531,2018,1,NPS,59,trigo
Puebla,2549,2319,2018,1,NPS,230,trigo
Querétaro de Arteaga,206,206,2018,1,D1,0,trigo
San Luis Potosí,250,195,2018,1,NPS,55,trigo
Tamaulipas,20,20,2018,1,NPS,0,trigo
Tlaxcala,19675,19675,2018,1,D0,0,trigo
Veracruz de Ignacio de la Llave,534,534,2018,1,NPS,0,trigo
Zacatecas,7816,7816,2018,1,NPS,0,trigo
Chiapas,48,48,2018,2,NPS,0,trigo
Chihuahua,170,170,2018,2,D0,0,trigo
Durango,4844,4844,2018,2,NPS,0,trigo
Guanajuato,13094,13094,2018,2,D2,0,trigo
Hidalgo,1652,1652,2018,2,NPS,0,trigo
Jalisco,1872,1872,2018,2,D0,0,trigo
Estado de México,5087,5087,2018,2,D0,0,trigo
Michoacán de Ocampo,429,429,2018,2,D1,0,trigo
Morelos,131,41,2018,2,D0,90,trigo
Nuevo León,35,35,2018,2,NPS,0,trigo
Oaxaca,11590,11590,2018,2,NPS,0,trigo
Puebla,2549,2549,2018,2,NPS,0,trigo
Querétaro de Arteaga,206,206,2018,2,D1,0,trigo
San Luis Potosí,250,195,2018,2,D0,55,trigo
Tamaulipas,20,20,2018,2,NPS,0,trigo
Tlaxcala,19675,19675,2018,2,D0,0,trigo
Veracruz de Ignacio de la Llave,534,534,2018,2,NPS,0,trigo
Zacatecas,7816,7816,2018,2,NPS,0,trigo
Chiapas,48,48,2018,3,D0,0,trigo
Chihuahua,170,170,2018,3,D0,0,trigo
Durango,4844,4844,2018,3,NPS,0,trigo
Guanajuato,13094,13094,2018,3,D2,0,trigo
Hidalgo,1652,1652,2018,3,NPS,0,trigo
Jalisco,1872,1872,2018,3,D0,0,trigo
Estado de México,5087,5087,2018,3,D0,0,trigo
Michoacán de Ocampo,429,429,2018,3,D1,0,trigo
Morelos,131,41,2018,3,D0,90,trigo
Nuevo León,35,35,2018,3,NPS,0,trigo
Oaxaca,11590,11590,2018,3,NPS,0,trigo
Puebla,2549,2549,2018,3,NPS,0,trigo
Querétaro de Arteaga,206,206,2018,3,D2,0,trigo
San Luis Potosí,250,195,2018,3,D0,55,trigo
Tamaulipas,20,20,2018,3,NPS,0,trigo
Tlaxcala,19675,19675,2018,3,D0,0,trigo
Veracruz de Ignacio de la Llave,534,534,2018,3,NPS,0,trigo
Zacatecas,7816,7816,2018,3,NPS,0,trigo
Estado de México,7355,10,2018,10,NPS,7345,trigo
Tlaxcala,20826,6395,2018,10,NPS,14431,trigo
Veracruz de Ignacio de la Llave,548,216,2018,10,D1,332,trigo
Chihuahua,100,100,2018,11,NPS,0,trigo
Guanajuato,14466,6411,2018,11,NPS,8055,trigo
Hidalgo,885,766,2018,11,D1,119,trigo
Estado de México,7355,830,2018,11,NPS,6525,trigo
Puebla,2053,1279,2018,11,NPS,774,trigo
Querétaro de Arteaga,201,201,2018,11,D1,0,trigo
San Luis Potosí,150,15,2018,11,NPS,135,trigo
Tamaulipas,48,48,2018,11,NPS,0,trigo
Tlaxcala,20826,18153,2018,11,NPS,2673,trigo
Veracruz de Ignacio de la Llave,548,458,2018,11,NPS,90,trigo
Zacatecas,8052,159,2018,11,NPS,7893,trigo
Chihuahua,100,100,2019,1,NPS,0,trigo
Durango,7322,7322,2019,1,NPS,0,trigo
Guanajuato,14466,14466,2019,1,NPS,0,trigo
Hidalgo,885,766,2019,1,D1,119,trigo
Jalisco,869,869,2019,1,NPS,0,trigo
Estado de México,7355,7340,2019,1,NPS,15,trigo
Michoacán de Ocampo,325,325,2019,1,NPS,0,trigo
Morelos,109,109,2019,1,NPS,0,trigo
Nuevo León,272,272,2019,1,NPS,0,trigo
Oaxaca,10388,9662,2019,1,NPS,726,trigo
Puebla,2053,2043,2019,1,NPS,10,trigo
Querétaro de Arteaga,201,201,2019,1,NPS,0,trigo
San Luis Potosí,150,60,2019,1,D0,90,trigo
Tamaulipas,48,48,2019,1,D0,0,trigo
Tlaxcala,20826,20826,2019,1,NPS,0,trigo
Veracruz de Ignacio de la Llave,548,548,2019,1,NPS,0,trigo
Zacatecas,8052,7914,2019,1,NPS,138,trigo
Chiapas,40,40,2019,2,D0,0,trigo
Chihuahua,100,100,2019,2,NPS,0,trigo
Durango,7322,7322,2019,2,D0,0,trigo
Guanajuato,14466,14466,2019,2,NPS,0,trigo
Hidalgo,885,766,2019,2,D1,119,trigo
Jalisco,869,869,2019,2,NPS,0,trigo
Estado de México,7355,7355,2019,2,NPS,0,trigo
Michoacán de Ocampo,325,325,2019,2,NPS,0,trigo
Morelos,109,109,2019,2,NPS,0,trigo
Nuevo León,272,272,2019,2,NPS,0,trigo
Oaxaca,10388,9718,2019,2,NPS,670,trigo
Puebla,2053,2053,2019,2,D0,0,trigo
Querétaro de Arteaga,201,201,2019,2,D0,0,trigo
San Luis Potosí,150,60,2019,2,D0,90,trigo
Tamaulipas,48,48,2019,2,D1,0,trigo
Tlaxcala,20826,20826,2019,2,NPS,0,trigo
Veracruz de Ignacio de la Llave,548,548,2019,2,D0,0,trigo
Zacatecas,8052,8032,2019,2,NPS,20,trigo
Chiapas,40,40,2019,3,D1,0,trigo
Chihuahua,100,100,2019,3,NPS,0,trigo
Durango,7322,7322,2019,3,D0,0,trigo
Guanajuato,14466,14466,2019,3,D0,0,trigo
Hidalgo,885,766,2019,3,D1,119,trigo
Jalisco,869,869,2019,3,D0,0,trigo
Estado de México,7355,7355,2019,3,NPS,0,trigo
Michoacán de Ocampo,325,325,2019,3,NPS,0,trigo
Morelos,109,109,2019,3,NPS,0,trigo
Nuevo León,272,272,2019,3,NPS,0,trigo
Oaxaca,10388,9718,2019,3,NPS,670,trigo
Puebla,2053,2053,2019,3,D0,0,trigo
Querétaro de Arteaga,201,201,2019,3,D0,0,trigo
San Luis Potosí,150,60,2019,3,D1,90,trigo
Tamaulipas,48,48,2019,3,D1,0,trigo
Tlaxcala,20826,20826,2019,3,NPS,0,trigo
Veracruz de Ignacio de la Llave,548,548,2019,3,D0,0,trigo
Zacatecas,8052,8032,2019,3,NPS,20,trigo
Veracruz de Ignacio de la Llave,534,144,2019,8,D2,390,trigo
Veracruz de Ignacio de la Llave,534,439,2019,9,D3,95,trigo
Estado de México,5393,686,2019,10,D0,4707,trigo
Tlaxcala,22638,6577,2019,10,NPS,16061,trigo
Veracruz de Ignacio de la Llave,534,534,2019,10,D3,0,trigo
Chihuahua,185,185,2019,11,NPS,0,trigo
Durango,6087,110,2019,11,D0,5977,trigo
Guanajuato,13208,2802,2019,11,D0,10406,trigo
Hidalgo,588,552,2019,11,D0,36,trigo
Estado de México,5393,1385,2019,11,NPS,4008,trigo
Puebla,2410,1489,2019,11,NPS,921,trigo
Querétaro de Arteaga,50,50,2019,11,D1,0,trigo
Tamaulipas,196,30,2019,11,D1,166,trigo
Tlaxcala,22638,16909,2019,11,NPS,5729,trigo
Veracruz de Ignacio de la Llave,534,534,2019,11,D2,0,trigo
Chiapas,44,44,2020,1,D0,0,trigo
Chihuahua,185,185,2020,1,NPS,0,trigo
Durango,6087,1859,2020,1,NPS,4228,trigo
Guanajuato,13208,13208,2020,1,D0,0,trigo
Hidalgo,588,564,2020,1,D0,24,trigo
Jalisco,890,688,2020,1,NPS,202,trigo
Estado de México,5393,5393,2020,1,NPS,0,trigo
Michoacán de Ocampo,560,370,2020,1,D1,190,trigo
Morelos,108,108,2020,1,NPS,0,trigo
Nuevo León,205,205,2020,1,D0,0,trigo
Oaxaca,9489,8179,2020,1,NPS,1310,trigo
Puebla,2410,2256,2020,1,NPS,154,trigo
Querétaro de Arteaga,50,50,2020,1,D1,0,trigo
Tamaulipas,196,98,2020,1,D1,98,trigo
Tlaxcala,22638,22638,2020,1,NPS,0,trigo
Veracruz de Ignacio de la Llave,534,534,2020,1,D1,0,trigo
Zacatecas,8608,3140,2020,1,NPS,5468,trigo
Chiapas,44,44,2020,2,D0,0,trigo
Chihuahua,185,185,2020,2,NPS,0,trigo
Durango,6087,6087,2020,2,NPS,0,trigo
Guanajuato,13208,13208,2020,2,NPS,0,trigo
Hidalgo,588,564,2020,2,D0,24,trigo
Jalisco,890,829,2020,2,NPS,61,trigo
Estado de México,5393,5393,2020,2,NPS,0,trigo
Michoacán de Ocampo,560,370,2020,2,D0,190,trigo
Morelos,108,108,2020,2,NPS,0,trigo
Nuevo León,205,205,2020,2,D0,0,trigo
Oaxaca,9489,8179,2020,2,NPS,1310,trigo
Puebla,2410,2410,2020,2,NPS,0,trigo
Querétaro de Arteaga,50,50,2020,2,D0,0,trigo
Tamaulipas,196,98,2020,2,D1,98,trigo
Tlaxcala,22638,22638,2020,2,NPS,0,trigo
Veracruz de Ignacio de la Llave,534,534,2020,2,NPS,0,trigo
Zacatecas,8608,3140,2020,2,NPS,5468,trigo
Chiapas,44,44,2020,3,D0,0,trigo
Chihuahua,185,185,2020,3,NPS,0,trigo
Durango,6087,6087,2020,3,NPS,0,trigo
Guanajuato,13208,13208,2020,3,D0,0,trigo
Hidalgo,588,564,2020,3,D0,24,trigo
Jalisco,890,890,2020,3,NPS,0,trigo
Estado de México,5393,5393,2020,3,NPS,0,trigo
Michoacán de Ocampo,560,560,2020,3,NPS,0,trigo
Morelos,108,108,2020,3,NPS,0,trigo
Nuevo León,205,205,2020,3,D2,0,trigo
Oaxaca,9489,9224,2020,3,NPS,265,trigo
Puebla,2410,2410,2020,3,NPS,0,trigo
Querétaro de Arteaga,50,50,2020,3,D0,0,trigo
Tamaulipas,196,98,2020,3,D1,98,trigo
Tlaxcala,22638,22638,2020,3,D0,0,trigo
Veracruz de Ignacio de la Llave,534,534,2020,3,D0,0,trigo
Zacatecas,8608,3954,2020,3,NPS,4654,trigo
Veracruz de Ignacio de la Llave,644,19,2020,8,NPS,625,trigo
Veracruz de Ignacio de la Llave,644,464,2020,9,D0,180,trigo
Tlaxcala,33607,9253,2020,10,NPS,24354,trigo
Veracruz de Ignacio de la Llave,644,624,2020,10,D0,20,trigo
Chihuahua,51,51,2020,11,D2,0,trigo
Durango,4473,10,2020,11,D0,4463,trigo
Guanajuato,12940,3215,2020,11,D1,9725,trigo
Hidalgo,571,329,2020,11,D0,242,trigo
Estado de México,3318,636,2020,11,D0,2682,trigo
Puebla,2081,1092,2020,11,NPS,989,trigo
Tamaulipas,150,65,2020,11,D1,85,trigo
Tlaxcala,33607,28372,2020,11,NPS,5235,trigo
Veracruz de Ignacio de la Llave,644,624,2020,11,D0,20,trigo
Zacatecas,7430,50,2020,11,D0,7380,trigo
